Patient,Arrival_Time,Wait_Time,Service_Start_Time,Service_Time,Service_End_Time,Queue_Length
1,2,0,2,3,5,0
1,5,0,5,3,8,0
2,11,0,11,3,14,0
3,23,0,23,3,26,0
4,33,0,33,3,36,0
4,36,0,36,3,39,0
5,37,2,39,3,42,1
6,46,0,46,3,49,0
7,52,0,52,3,55,0
8,56,0,56,3,59,0
8,59,0,59,3,62,0
9,60,2,62,3,65,1
10,64,1,65,3,68,1
9,65,3,68,3,71,1
11,67,4,71,3,74,2
12,69,5,74,3,77,2
13,74,3,77,3,80,1
12,77,3,80,3,83,1
14,79,4,83,3,86,2
15,82,4,86,3,89,2
14,86,3,89,3,92,1
16,89,3,92,3,95,1
17,93,2,95,3,98,1
18,96,2,98,3,101,1
18,101,0,101,3,104,0
19,102,2,104,3,107,1
19,107,0,107,3,110,0
19,110,0,110,3,113,0
20,110,3,113,3,116,1
19,113,3,116,3,119,1
21,118,1,119,3,122,1
22,121,1,122,3,125,1
23,128,0,128,3,131,0
24,137,0,137,3,140,0
25,147,0,147,3,150,0
26,150,0,150,3,153,0
27,154,0,154,3,157,0
27,157,0,157,3,160,0
27,160,0,160,3,163,0
28,162,1,163,3,166,1
27,163,3,166,3,169,1
29,170,0,170,3,173,0
29,173,0,173,3,176,0
30,175,1,176,3,179,1
31,180,0,180,3,183,0
32,185,0,185,3,188,0
33,190,0,190,3,193,0
33,193,0,193,3,196,0
34,197,0,197,3,200,0
34,200,0,200,3,203,0
35,203,0,203,3,206,0
36,209,0,209,3,212,0
37,210,2,212,3,215,1
38,211,4,215,3,218,2
37,215,3,218,3,221,1
39,215,6,221,3,224,2
37,218,6,224,3,227,2
40,220,7,227,3,230,3
38,224,6,230,3,233,2
41,224,9,233,3,236,3
42,227,9,236,3,239,3
43,228,11,239,3,242,4
44,233,9,242,3,245,3
41,236,9,245,3,248,3
45,236,12,248,3,251,4
46,239,12,251,3,254,4
47,243,11,254,3,257,4
48,247,10,257,3,260,4
44,248,12,260,3,263,4
49,250,13,263,3,266,5
44,251,15,266,3,269,5
44,254,15,269,3,272,5
50,255,17,272,3,275,6
45,260,15,275,3,278,5
51,260,18,278,3,281,6
45,263,18,281,3,284,6
45,266,18,284,3,287,6
52,267,20,287,3,290,7
53,271,19,290,3,293,7
46,272,21,293,3,296,7
54,272,24,296,3,299,8
55,278,21,299,3,302,7
56,278,24,302,3,305,8
57,281,24,305,3,308,8
58,283,25,308,3,311,9
59,285,26,311,3,314,9
60,289,25,314,3,317,9
51,290,27,317,3,320,9
61,291,29,320,3,323,10
62,292,31,323,3,326,11
51,293,33,326,3,329,11
51,296,33,329,3,332,11
63,302,30,332,3,335,10
64,307,28,335,3,338,10
65,310,28,338,3,341,10
66,313,28,341,3,344,10
56,314,30,344,3,347,10
67,318,29,347,3,350,10
68,322,28,350,3,353,10
69,326,27,353,3,356,9
70,331,25,356,3,359,9
71,337,22,359,3,362,8
63,338,24,362,3,365,8
72,339,26,365,3,368,9
63,341,27,368,3,371,9
73,343,28,371,3,374,10
64,347,27,374,3,377,9
74,348,29,377,3,380,10
75,352,28,380,3,383,10
76,359,24,383,3,386,8
77,364,22,386,3,389,8
69,365,24,389,3,392,8
78,369,23,392,3,395,8
79,374,21,395,3,398,7
80,375,23,398,3,401,8
81,383,18,401,3,404,6
75,386,18,404,3,407,6
82,388,19,407,3,410,7
83,390,20,410,3,413,7
76,392,21,413,3,416,7
84,394,22,416,3,419,8
85,396,23,419,3,422,8
77,398,24,422,3,425,8
77,401,24,425,3,428,8
86,402,26,428,3,431,9
87,404,27,431,3,434,9
88,411,23,434,3,437,8
89,414,23,437,3,440,8
90,417,23,440,3,443,8
82,419,24,443,3,446,8
91,421,25,446,3,449,9
82,422,27,449,3,452,9
82,425,27,452,3,455,9
92,427,28,455,3,458,10
82,428,30,458,3,461,10
83,434,27,461,3,464,9
93,436,28,464,3,467,10
83,437,30,467,3,470,10
94,441,29,470,3,473,10
95,447,26,473,3,476,9
96,453,23,476,3,479,8
97,460,19,479,3,482,7
98,461,21,482,3,485,7
99,465,20,485,3,488,7
100,469,19,488,3,491,7
93,470,21,491,3,494,7
93,473,21,494,3,497,7
101,475,22,497,3,500,8
102,477,23,500,3,503,8
103,477,26,503,3,506,9
104,483,23,506,3,509,8
97,488,21,509,3,512,7
105,493,19,512,3,515,7
106,498,17,515,3,518,6
107,505,13,518,3,521,5
108,508,13,521,3,524,5
104,512,12,524,3,527,4
109,514,13,527,3,530,5
106,521,9,530,3,533,3
110,524,9,533,3,536,3
107,527,9,536,3,539,3
111,529,10,539,3,542,4
108,533,9,542,3,545,3
112,534,11,545,3,548,4
113,541,7,548,3,551,3
114,544,7,551,3,554,3
111,545,9,554,3,557,3
111,548,9,557,3,560,3
115,549,11,560,3,563,4
111,551,12,563,3,566,4
116,553,13,566,3,569,5
117,561,8,569,3,572,3
114,563,9,572,3,575,3
118,565,10,575,3,578,4
119,569,9,578,3,581,3
116,572,9,581,3,584,3
120,573,11,584,3,587,4
116,575,12,587,3,590,4
121,579,11,590,3,593,4
122,582,11,593,3,596,4
123,585,11,596,3,599,4
124,591,8,599,3,602,3
125,598,4,602,3,605,2
123,599,6,605,3,608,2
126,603,5,608,3,611,2
124,605,6,611,3,614,2
125,611,3,614,3,617,1
127,613,4,617,3,620,2
128,619,1,620,3,623,1
127,620,3,623,3,626,1
128,626,0,626,3,629,0
129,627,2,629,3,632,1
130,631,1,632,3,635,1
129,632,3,635,3,638,1
131,635,3,638,3,641,1
132,638,3,641,3,644,1
133,644,0,644,3,647,0
134,649,0,649,3,652,0
135,656,0,656,3,659,0
136,658,1,659,3,662,1
137,661,1,662,3,665,1
136,662,3,665,3,668,1
136,665,3,668,3,671,1
138,667,4,671,3,674,2
139,673,1,674,3,677,1
138,674,3,677,3,680,1
139,680,0,680,3,683,0
140,683,0,683,3,686,0
141,692,0,692,3,695,0
142,696,0,696,3,699,0
142,699,0,699,3,702,0
143,699,3,702,3,705,1
144,701,4,705,3,708,2
145,709,0,709,3,712,0
146,715,0,715,3,718,0
146,718,0,718,3,721,0
147,722,0,722,3,725,0
148,730,0,730,3,733,0
149,739,0,739,3,742,0
149,742,0,742,3,745,0
150,745,0,745,3,748,0
151,750,0,750,3,753,0
151,753,0,753,3,756,0
152,754,2,756,3,759,1
153,759,0,759,3,762,0
153,762,0,762,3,765,0
154,767,0,767,3,770,0
155,778,0,778,3,781,0
156,784,0,784,3,787,0
156,787,0,787,3,790,0
157,795,0,795,3,798,0
158,798,0,798,3,801,0
159,803,0,803,3,806,0
159,806,0,806,3,809,0
160,809,0,809,3,812,0
160,812,0,812,3,815,0
161,814,1,815,3,818,1
162,818,0,818,3,821,0
163,824,0,824,3,827,0
164,829,0,829,3,832,0
165,836,0,836,3,839,0
165,839,0,839,3,842,0
166,839,3,842,3,845,1
167,844,1,845,3,848,1
166,845,3,848,3,851,1
168,852,0,852,3,855,0
168,855,0,855,3,858,0
169,856,2,858,3,861,1
170,865,0,865,3,868,0
171,869,0,869,3,872,0
172,876,0,876,3,879,0
173,880,0,880,3,883,0
174,882,1,883,3,886,1
173,883,3,886,3,889,1
173,886,3,889,3,892,1
175,888,4,892,3,895,2
176,891,4,895,3,898,2
177,896,2,898,3,901,1
177,901,0,901,3,904,0
178,902,2,904,3,907,1
179,906,1,907,3,910,1
178,907,3,910,3,913,1
180,916,0,916,3,919,0
181,919,0,919,3,922,0
182,923,0,923,3,926,0
183,925,1,926,3,929,1
184,929,0,929,3,932,0
185,934,0,934,3,937,0
185,937,0,937,3,940,0
186,938,2,940,3,943,1
187,941,2,943,3,946,1
186,943,3,946,3,949,1
188,946,3,949,3,952,1
189,951,1,952,3,955,1
190,953,2,955,3,958,1
189,955,3,958,3,961,1
191,959,2,961,3,964,1
190,961,3,964,3,967,1
192,965,2,967,3,970,1
193,968,2,970,3,973,1
194,971,2,973,3,976,1
193,973,3,976,3,979,1
195,976,3,979,3,982,1
194,979,3,982,3,985,1
196,983,2,985,3,988,1
197,983,5,988,3,991,2
198,985,6,991,3,994,2
199,987,7,994,3,997,3
200,991,6,997,3,1000,2
201,999,1,1000,3,1003,1
202,1005,0,1005,3,1008,0
203,1007,1,1008,3,1011,1
204,1014,0,1014,3,1017,0
205,1018,0,1018,3,1021,0
206,1022,0,1022,3,1025,0
207,1027,0,1027,3,1030,0
208,1031,0,1031,3,1034,0
209,1035,0,1035,3,1038,0
210,1043,0,1043,3,1046,0
211,1048,0,1048,3,1051,0
212,1051,0,1051,3,1054,0
213,1056,0,1056,3,1059,0
214,1057,2,1059,3,1062,1
213,1059,3,1062,3,1065,1
214,1065,0,1065,3,1068,0
215,1066,2,1068,3,1071,1
216,1072,0,1072,3,1075,0
217,1075,0,1075,3,1078,0
218,1080,0,1080,3,1083,0
218,1083,0,1083,3,1086,0
219,1083,3,1086,3,1089,1
220,1087,2,1089,3,1092,1
221,1091,1,1092,3,1095,1
220,1092,3,1095,3,1098,1
222,1095,3,1098,3,1101,1
223,1097,4,1101,3,1104,2
221,1098,6,1104,3,1107,2
224,1100,7,1107,3,1110,3
221,1101,9,1110,3,1113,3
225,1109,4,1113,3,1116,2
226,1112,4,1116,3,1119,2
227,1119,0,1119,3,1122,0
227,1122,0,1122,3,1125,0
228,1124,1,1125,3,1128,1
227,1125,3,1128,3,1131,1
229,1127,4,1131,3,1134,2
230,1130,4,1134,3,1137,2
228,1131,6,1137,3,1140,2
231,1135,5,1140,3,1143,2
229,1137,6,1143,3,1146,2
232,1139,7,1146,3,1149,3
229,1140,9,1149,3,1152,3
233,1145,7,1152,3,1155,3
231,1149,6,1155,3,1158,2
234,1151,7,1158,3,1161,3
231,1152,9,1161,3,1164,3
235,1155,9,1164,3,1167,3
236,1163,4,1167,3,1170,2
234,1164,6,1170,3,1173,2
234,1167,6,1173,3,1176,2
234,1170,6,1176,3,1179,2
237,1172,7,1179,3,1182,3
236,1179,3,1182,3,1185,1
238,1179,6,1185,3,1188,2
239,1180,8,1188,3,1191,3
240,1182,9,1191,3,1194,3
237,1185,9,1194,3,1197,3
241,1190,7,1197,3,1200,3
242,1193,7,1200,3,1203,3
240,1197,6,1203,3,1206,2
243,1197,9,1206,3,1209,3
244,1202,7,1209,3,1212,3
243,1209,3,1212,3,1215,1
245,1209,6,1215,3,1218,2
246,1211,7,1218,3,1221,3
244,1215,6,1221,3,1224,2
247,1218,6,1224,3,1227,2
248,1220,7,1227,3,1230,3
249,1223,7,1230,3,1233,3
250,1227,6,1233,3,1236,2
251,1231,5,1236,3,1239,2
249,1233,6,1239,3,1242,2
252,1241,1,1242,3,1245,1
253,1242,3,1245,3,1248,1
254,1245,3,1248,3,1251,1
255,1248,3,1251,3,1254,1
256,1253,1,1254,3,1257,1
257,1257,0,1257,3,1260,0
258,1262,0,1262,3,1265,0
259,1269,0,1269,3,1272,0
260,1272,0,1272,3,1275,0
260,1275,0,1275,3,1278,0
261,1276,2,1278,3,1281,1
262,1281,0,1281,3,1284,0
262,1284,0,1284,3,1287,0
263,1284,3,1287,3,1290,1
262,1287,3,1290,3,1293,1
264,1288,5,1293,3,1296,2
265,1291,5,1296,3,1299,2
266,1293,6,1299,3,1302,2
265,1299,3,1302,3,1305,1
267,1299,6,1305,3,1308,2
265,1302,6,1308,3,1311,2
268,1302,9,1311,3,1314,3
265,1305,9,1314,3,1317,3
269,1308,9,1317,3,1320,3
270,1313,7,1320,3,1323,3
268,1317,6,1323,3,1326,2
271,1320,6,1326,3,1329,2
272,1325,4,1329,3,1332,2
273,1330,2,1332,3,1335,1
272,1332,3,1335,3,1338,1
274,1334,4,1338,3,1341,2
275,1340,1,1341,3,1344,1
274,1341,3,1344,3,1347,1
276,1342,5,1347,3,1350,2
275,1347,3,1350,3,1353,1
277,1351,2,1353,3,1356,1
278,1354,2,1356,3,1359,1
278,1359,0,1359,3,1362,0
279,1361,1,1362,3,1365,1
280,1369,0,1369,3,1372,0
281,1375,0,1375,3,1378,0
281,1378,0,1378,3,1381,0
282,1383,0,1383,3,1386,0
283,1389,0,1389,3,1392,0
284,1393,0,1393,3,1396,0
284,1396,0,1396,3,1399,0
285,1396,3,1399,3,1402,1
284,1399,3,1402,3,1405,1
286,1402,3,1405,3,1408,1
287,1404,4,1408,3,1411,2
288,1408,3,1411,3,1414,1
289,1415,0,1415,3,1418,0
290,1422,0,1422,3,1425,0
291,1424,1,1425,3,1428,1
290,1425,3,1428,3,1431,1
290,1428,3,1431,3,1434,1
290,1431,3,1434,3,1437,1
292,1432,5,1437,3,1440,2
293,1437,3,1440,3,1443,1
293,1443,0,1443,3,1446,0
294,1446,0,1446,3,1449,0
294,1449,0,1449,3,1452,0
295,1456,0,1456,3,1459,0
296,1458,1,1459,3,1462,1
297,1467,0,1467,3,1470,0
298,1469,1,1470,3,1473,1
297,1470,3,1473,3,1476,1
297,1473,3,1476,3,1479,1
299,1478,1,1479,3,1482,1
298,1479,3,1482,3,1485,1
300,1481,4,1485,3,1488,2
299,1485,3,1488,3,1491,1
301,1488,3,1491,3,1494,1
302,1496,0,1496,3,1499,0
303,1499,0,1499,3,1502,0
304,1503,0,1503,3,1506,0
305,1510,0,1510,3,1513,0
306,1512,1,1513,3,1516,1
307,1519,0,1519,3,1522,0
308,1527,0,1527,3,1530,0
308,1530,0,1530,3,1533,0
309,1533,0,1533,3,1536,0
310,1536,0,1536,3,1539,0
311,1543,0,1543,3,1546,0
312,1547,0,1547,3,1550,0
313,1555,0,1555,3,1558,0
314,1562,0,1562,3,1565,0
315,1568,0,1568,3,1571,0
316,1575,0,1575,3,1578,0
317,1578,0,1578,3,1581,0
318,1587,0,1587,3,1590,0
318,1590,0,1590,3,1593,0
319,1591,2,1593,3,1596,1
318,1593,3,1596,3,1599,1
320,1596,3,1599,3,1602,1
320,1602,0,1602,3,1605,0
321,1602,3,1605,3,1608,1
322,1605,3,1608,3,1611,1
323,1609,2,1611,3,1614,1
324,1612,2,1614,3,1617,1
323,1614,3,1617,3,1620,1
325,1616,4,1620,3,1623,2
323,1617,6,1623,3,1626,2
323,1620,6,1626,3,1629,2
326,1621,8,1629,3,1632,3
324,1626,6,1632,3,1635,2
327,1628,7,1635,3,1638,3
328,1631,7,1638,3,1641,3
329,1635,6,1641,3,1644,2
327,1638,6,1644,3,1647,2
330,1638,9,1647,3,1650,3
331,1639,11,1650,3,1653,4
332,1643,10,1653,3,1656,4
328,1644,12,1656,3,1659,4
328,1647,12,1659,3,1662,4
333,1648,14,1662,3,1665,5
329,1653,12,1665,3,1668,4
334,1655,13,1668,3,1671,5
331,1662,9,1671,3,1674,3
335,1662,12,1674,3,1677,4
332,1668,9,1677,3,1680,3
336,1672,8,1680,3,1683,3
337,1678,5,1683,3,1686,2
336,1683,3,1686,3,1689,1
338,1687,2,1689,3,1692,1
337,1689,3,1692,3,1695,1
339,1689,6,1695,3,1698,2
337,1692,6,1698,3,1701,2
340,1695,6,1701,3,1704,2
339,1701,3,1704,3,1707,1
341,1703,4,1707,3,1710,2
339,1704,6,1710,3,1713,2
342,1711,2,1713,3,1716,1
343,1718,0,1718,3,1721,0
344,1720,1,1721,3,1724,1
344,1724,0,1724,3,1727,0
345,1725,2,1727,3,1730,1
346,1733,0,1733,3,1736,0
347,1736,0,1736,3,1739,0
347,1739,0,1739,3,1742,0
348,1739,3,1742,3,1745,1
348,1745,0,1745,3,1748,0
349,1750,0,1750,3,1753,0
350,1754,0,1754,3,1757,0
351,1763,0,1763,3,1766,0
352,1767,0,1767,3,1770,0
352,1770,0,1770,3,1773,0
353,1771,2,1773,3,1776,1
354,1776,0,1776,3,1779,0
355,1781,0,1781,3,1784,0
356,1785,0,1785,3,1788,0
357,1790,0,1790,3,1793,0
358,1795,0,1795,3,1798,0
359,1798,0,1798,3,1801,0
359,1801,0,1801,3,1804,0
360,1807,0,1807,3,1810,0
360,1810,0,1810,3,1813,0
361,1812,1,1813,3,1816,1
361,1816,0,1816,3,1819,0
362,1819,0,1819,3,1822,0
363,1828,0,1828,3,1831,0
364,1834,0,1834,3,1837,0
365,1838,0,1838,3,1841,0
366,1844,0,1844,3,1847,0
367,1849,0,1849,3,1852,0
368,1855,0,1855,3,1858,0
369,1866,0,1866,3,1869,0
370,1874,0,1874,3,1877,0
370,1877,0,1877,3,1880,0
371,1879,1,1880,3,1883,1
372,1886,0,1886,3,1889,0
372,1889,0,1889,3,1892,0
373,1892,0,1892,3,1895,0
374,1897,0,1897,3,1900,0
374,1900,0,1900,3,1903,0
375,1902,1,1903,3,1906,1
376,1907,0,1907,3,1910,0
377,1914,0,1914,3,1917,0
378,1916,1,1917,3,1920,1
378,1920,0,1920,3,1923,0
379,1921,2,1923,3,1926,1
380,1925,1,1926,3,1929,1
380,1929,0,1929,3,1932,0
381,1930,2,1932,3,1935,1
382,1935,0,1935,3,1938,0
383,1940,0,1940,3,1943,0
384,1943,0,1943,3,1946,0
385,1946,0,1946,3,1949,0
385,1949,0,1949,3,1952,0
386,1952,0,1952,3,1955,0
387,1953,2,1955,3,1958,1
387,1958,0,1958,3,1961,0
388,1960,1,1961,3,1964,1
389,1962,2,1964,3,1967,1
390,1964,3,1967,3,1970,1
391,1966,4,1970,3,1973,2
390,1970,3,1973,3,1976,1
392,1972,4,1976,3,1979,2
393,1975,4,1979,3,1982,2
394,1980,2,1982,3,1985,1
393,1982,3,1985,3,1988,1
395,1985,3,1988,3,1991,1
396,1988,3,1991,3,1994,1
395,1991,3,1994,3,1997,1
397,1993,4,1997,3,2000,2
395,1994,6,2000,3,2003,2
398,1995,8,2003,3,2006,3
395,1997,9,2006,3,2009,3
399,2001,8,2009,3,2012,3
396,2003,9,2012,3,2015,3
400,2007,8,2015,3,2018,3
398,2012,6,2018,3,2021,2
401,2013,8,2021,3,2024,3
402,2017,7,2024,3,2027,3
403,2022,5,2027,3,2030,2
404,2026,4,2030,3,2033,2
405,2028,5,2033,3,2036,2
406,2032,4,2036,3,2039,2
404,2033,6,2039,3,2042,2
407,2036,6,2042,3,2045,2
408,2041,4,2045,3,2048,2
407,2045,3,2048,3,2051,1
409,2047,4,2051,3,2054,2
408,2051,3,2054,3,2057,1
410,2052,5,2057,3,2060,2
411,2057,3,2060,3,2063,1
412,2065,0,2065,3,2068,0
412,2068,0,2068,3,2071,0
413,2071,0,2071,3,2074,0
414,2079,0,2079,3,2082,0
415,2085,0,2085,3,2088,0
416,2087,1,2088,3,2091,1
415,2088,3,2091,3,2094,1
417,2093,1,2094,3,2097,1
418,2099,0,2099,3,2102,0
419,2105,0,2105,3,2108,0
419,2108,0,2108,3,2111,0
420,2111,0,2111,3,2114,0
421,2121,0,2121,3,2124,0
422,2129,0,2129,3,2132,0
423,2132,0,2132,3,2135,0
424,2138,0,2138,3,2141,0
425,2141,0,2141,3,2144,0
426,2145,0,2145,3,2148,0
427,2149,0,2149,3,2152,0
428,2153,0,2153,3,2156,0
429,2156,0,2156,3,2159,0
430,2162,0,2162,3,2165,0
431,2167,0,2167,3,2170,0
431,2170,0,2170,3,2173,0
432,2172,1,2173,3,2176,1
433,2179,0,2179,3,2182,0
434,2185,0,2185,3,2188,0
435,2189,0,2189,3,2192,0
436,2197,0,2197,3,2200,0
436,2200,0,2200,3,2203,0
437,2201,2,2203,3,2206,1
438,2206,0,2206,3,2209,0
439,2212,0,2212,3,2215,0
440,2213,2,2215,3,2218,1
439,2215,3,2218,3,2221,1
441,2217,4,2221,3,2224,2
439,2218,6,2224,3,2227,2
440,2224,3,2227,3,2230,1
440,2227,3,2230,3,2233,1
442,2227,6,2233,3,2236,2
443,2234,2,2236,3,2239,1
442,2236,3,2239,3,2242,1
444,2238,4,2242,3,2245,2
445,2243,2,2245,3,2248,1
446,2246,2,2248,3,2251,1
447,2250,1,2251,3,2254,1
446,2251,3,2254,3,2257,1
448,2258,0,2258,3,2261,0
449,2263,0,2263,3,2266,0
450,2268,0,2268,3,2271,0
451,2271,0,2271,3,2274,0
452,2278,0,2278,3,2281,0
453,2288,0,2288,3,2291,0
454,2291,0,2291,3,2294,0
455,2295,0,2295,3,2298,0
456,2298,0,2298,3,2301,0
457,2300,1,2301,3,2304,1
456,2301,3,2304,3,2307,1
458,2304,3,2307,3,2310,1
457,2307,3,2310,3,2313,1
459,2311,2,2313,3,2316,1
460,2313,3,2316,3,2319,1
459,2316,3,2319,3,2322,1
461,2318,4,2322,3,2325,2
462,2322,3,2325,3,2328,1
463,2328,0,2328,3,2331,0
463,2331,0,2331,3,2334,0
464,2332,2,2334,3,2337,1
463,2334,3,2337,3,2340,1
465,2336,4,2340,3,2343,2
463,2337,6,2343,3,2346,2
466,2340,6,2346,3,2349,2
467,2341,8,2349,3,2352,3
468,2346,6,2352,3,2355,2
469,2355,0,2355,3,2358,0
470,2359,0,2359,3,2362,0
471,2368,0,2368,3,2371,0
471,2371,0,2371,3,2374,0
472,2375,0,2375,3,2378,0
472,2378,0,2378,3,2381,0
472,2381,0,2381,3,2384,0
473,2382,2,2384,3,2387,1
474,2386,1,2387,3,2390,1
475,2392,0,2392,3,2395,0
476,2401,0,2401,3,2404,0
477,2405,0,2405,3,2408,0
478,2412,0,2412,3,2415,0
479,2414,1,2415,3,2418,1
478,2415,3,2418,3,2421,1
478,2418,3,2421,3,2424,1
480,2419,5,2424,3,2427,2
481,2425,2,2427,3,2430,1
481,2430,0,2430,3,2433,0
482,2430,3,2433,3,2436,1
483,2434,2,2436,3,2439,1
482,2436,3,2439,3,2442,1
484,2440,2,2442,3,2445,1
485,2444,1,2445,3,2448,1
486,2450,0,2450,3,2453,0
486,2453,0,2453,3,2456,0
486,2456,0,2456,3,2459,0
487,2456,3,2459,3,2462,1
488,2460,2,2462,3,2465,1
487,2462,3,2465,3,2468,1
489,2464,4,2468,3,2471,2
490,2467,4,2471,3,2474,2
491,2467,7,2474,3,2477,3
492,2473,4,2477,3,2480,2
493,2474,6,2480,3,2483,2
494,2477,6,2483,3,2486,2
495,2483,3,2486,3,2489,1
496,2484,5,2489,3,2492,2
497,2492,0,2492,3,2495,0
498,2495,0,2495,3,2498,0
499,2500,0,2500,3,2503,0
500,2508,0,2508,3,2511,0
500,2511,0,2511,3,2514,0
500,2514,0,2514,3,2517,0
501,2514,3,2517,3,2520,1
502,2515,5,2520,3,2523,2
503,2518,5,2523,3,2526,2
504,2523,3,2526,3,2529,1
503,2526,3,2529,3,2532,1
505,2529,3,2532,3,2535,1
506,2535,0,2535,3,2538,0
507,2542,0,2542,3,2545,0
508,2547,0,2547,3,2550,0
509,2550,0,2550,3,2553,0
510,2556,0,2556,3,2559,0
510,2559,0,2559,3,2562,0
511,2561,1,2562,3,2565,1
510,2562,3,2565,3,2568,1
512,2568,0,2568,3,2571,0
512,2571,0,2571,3,2574,0
513,2575,0,2575,3,2578,0
513,2578,0,2578,3,2581,0
514,2581,0,2581,3,2584,0
514,2584,0,2584,3,2587,0
515,2586,1,2587,3,2590,1
516,2592,0,2592,3,2595,0
516,2595,0,2595,3,2598,0
517,2599,0,2599,3,2602,0
518,2603,0,2603,3,2606,0
518,2606,0,2606,3,2609,0
519,2607,2,2609,3,2612,1
520,2609,3,2612,3,2615,1
521,2617,0,2617,3,2620,0
522,2622,0,2622,3,2625,0
523,2628,0,2628,3,2631,0
524,2634,0,2634,3,2637,0
525,2639,0,2639,3,2642,0
526,2643,0,2643,3,2646,0
527,2647,0,2647,3,2650,0
527,2650,0,2650,3,2653,0
528,2650,3,2653,3,2656,1
528,2656,0,2656,3,2659,0
528,2659,0,2659,3,2662,0
529,2659,3,2662,3,2665,1
530,2667,0,2667,3,2670,0
531,2676,0,2676,3,2679,0
532,2681,0,2681,3,2684,0
533,2685,0,2685,3,2688,0
533,2688,0,2688,3,2691,0
534,2688,3,2691,3,2694,1
533,2691,3,2694,3,2697,1
535,2694,3,2697,3,2700,1
536,2699,1,2700,3,2703,1
537,2702,1,2703,3,2706,1
538,2706,0,2706,3,2709,0
538,2709,0,2709,3,2712,0
539,2712,0,2712,3,2715,0
540,2717,0,2717,3,2720,0
541,2723,0,2723,3,2726,0
541,2726,0,2726,3,2729,0
541,2729,0,2729,3,2732,0
542,2730,2,2732,3,2735,1
541,2732,3,2735,3,2738,1
543,2732,6,2738,3,2741,2
544,2734,7,2741,3,2744,3
543,2741,3,2744,3,2747,1
545,2743,4,2747,3,2750,2
546,2750,0,2750,3,2753,0
547,2755,0,2755,3,2758,0
548,2759,0,2759,3,2762,0
549,2763,0,2763,3,2766,0
550,2765,1,2766,3,2769,1
551,2768,1,2769,3,2772,1
552,2770,2,2772,3,2775,1
551,2772,3,2775,3,2778,1
553,2775,3,2778,3,2781,1
554,2781,0,2781,3,2784,0
554,2784,0,2784,3,2787,0
555,2784,3,2787,3,2790,1
556,2797,0,2797,3,2800,0
557,2799,1,2800,3,2803,1
558,2804,0,2804,3,2807,0
559,2805,2,2807,3,2810,1
560,2811,0,2811,3,2814,0
560,2814,0,2814,3,2817,0
561,2815,2,2817,3,2820,1
561,2820,0,2820,3,2823,0
562,2820,3,2823,3,2826,1
563,2824,2,2826,3,2829,1
564,2826,3,2829,3,2832,1
565,2827,5,2832,3,2835,2
563,2829,6,2835,3,2838,2
566,2832,6,2838,3,2841,2
564,2835,6,2841,3,2844,2
567,2837,7,2844,3,2847,3
568,2841,6,2847,3,2850,2
569,2841,9,2850,3,2853,3
570,2845,8,2853,3,2856,3
567,2847,9,2856,3,2859,3
571,2851,8,2859,3,2862,3
572,2856,6,2862,3,2865,2
573,2862,3,2865,3,2868,1
574,2865,3,2868,3,2871,1
575,2871,0,2871,3,2874,0
576,2875,0,2875,3,2878,0
577,2876,2,2878,3,2881,1
578,2882,0,2882,3,2885,0
579,2886,0,2886,3,2889,0
580,2888,1,2889,3,2892,1
580,2892,0,2892,3,2895,0
581,2893,2,2895,3,2898,1
582,2898,0,2898,3,2901,0
583,2901,0,2901,3,2904,0
584,2908,0,2908,3,2911,0
584,2911,0,2911,3,2914,0
585,2914,0,2914,3,2917,0
586,2924,0,2924,3,2927,0
587,2929,0,2929,3,2932,0
588,2932,0,2932,3,2935,0
589,2940,0,2940,3,2943,0
590,2946,0,2946,3,2949,0
590,2949,0,2949,3,2952,0
590,2952,0,2952,3,2955,0
591,2952,3,2955,3,2958,1
592,2959,0,2959,3,2962,0
592,2962,0,2962,3,2965,0
592,2965,0,2965,3,2968,0
593,2966,2,2968,3,2971,1
594,2972,0,2972,3,2975,0
595,2976,0,2976,3,2979,0
596,2985,0,2985,3,2988,0
597,2993,0,2993,3,2996,0
598,2998,0,2998,3,3001,0
598,3001,0,3001,3,3004,0
599,3005,0,3005,3,3008,0
600,3008,0,3008,3,3011,0
600,3011,0,3011,3,3014,0
601,3012,2,3014,3,3017,1
602,3016,1,3017,3,3020,1
603,3024,0,3024,3,3027,0
603,3027,0,3027,3,3030,0
604,3029,1,3030,3,3033,1
605,3033,0,3033,3,3036,0
606,3035,1,3036,3,3039,1
607,3040,0,3040,3,3043,0
608,3047,0,3047,3,3050,0
609,3053,0,3053,3,3056,0
609,3056,0,3056,3,3059,0
610,3057,2,3059,3,3062,1
611,3064,0,3064,3,3067,0
612,3069,0,3069,3,3072,0
612,3072,0,3072,3,3075,0
613,3075,0,3075,3,3078,0
614,3080,0,3080,3,3083,0
615,3084,0,3084,3,3087,0
616,3084,3,3087,3,3090,1
615,3087,3,3090,3,3093,1
617,3089,4,3093,3,3096,2
615,3090,6,3096,3,3099,2
616,3096,3,3099,3,3102,1
618,3096,6,3102,3,3105,2
616,3099,6,3105,3,3108,2
619,3099,9,3108,3,3111,3
620,3104,7,3111,3,3114,3
617,3105,9,3114,3,3117,3
621,3113,4,3117,3,3120,2
622,3119,1,3120,3,3123,1
623,3121,2,3123,3,3126,1
624,3126,0,3126,3,3129,0
625,3134,0,3134,3,3137,0
626,3139,0,3139,3,3142,0
627,3144,0,3144,3,3147,0
628,3148,0,3148,3,3151,0
629,3154,0,3154,3,3157,0
629,3157,0,3157,3,3160,0
629,3160,0,3160,3,3163,0
630,3162,1,3163,3,3166,1
631,3166,0,3166,3,3169,0
631,3169,0,3169,3,3172,0
632,3171,1,3172,3,3175,1
631,3172,3,3175,3,3178,1
633,3177,1,3178,3,3181,1
634,3182,0,3182,3,3185,0
635,3187,0,3187,3,3190,0
635,3190,0,3190,3,3193,0
636,3191,2,3193,3,3196,1
635,3193,3,3196,3,3199,1
637,3195,4,3199,3,3202,2
638,3199,3,3202,3,3205,1
639,3205,0,3205,3,3208,0
639,3208,0,3208,3,3211,0
640,3208,3,3211,3,3214,1
641,3212,2,3214,3,3217,1
642,3213,4,3217,3,3220,2
640,3214,6,3220,3,3223,2
643,3216,7,3223,3,3226,3
640,3217,9,3226,3,3229,3
641,3223,6,3229,3,3232,2
644,3225,7,3232,3,3235,3
645,3228,7,3235,3,3238,3
646,3236,2,3238,3,3241,1
647,3243,0,3243,3,3246,0
648,3250,0,3250,3,3253,0
649,3254,0,3254,3,3257,0
650,3257,0,3257,3,3260,0
651,3261,0,3261,3,3264,0
651,3264,0,3264,3,3267,0
652,3266,1,3267,3,3270,1
652,3270,0,3270,3,3273,0
653,3273,0,3273,3,3276,0
654,3276,0,3276,3,3279,0
655,3281,0,3281,3,3284,0
656,3284,0,3284,3,3287,0
657,3288,0,3288,3,3291,0
658,3290,1,3291,3,3294,1
657,3291,3,3294,3,3297,1
659,3292,5,3297,3,3300,2
660,3297,3,3300,3,3303,1
659,3300,3,3303,3,3306,1
661,3301,5,3306,3,3309,2
662,3301,8,3309,3,3312,3
663,3305,7,3312,3,3315,3
664,3308,7,3315,3,3318,3
665,3314,4,3318,3,3321,2
666,3324,0,3324,3,3327,0
667,3327,0,3327,3,3330,0
667,3330,0,3330,3,3333,0
668,3334,0,3334,3,3337,0
668,3337,0,3337,3,3340,0
669,3338,2,3340,3,3343,1
669,3343,0,3343,3,3346,0
670,3343,3,3346,3,3349,1
671,3348,1,3349,3,3352,1
670,3349,3,3352,3,3355,1
670,3352,3,3355,3,3358,1
672,3356,2,3358,3,3361,1
673,3362,0,3362,3,3365,0
674,3368,0,3368,3,3371,0
675,3374,0,3374,3,3377,0
675,3377,0,3377,3,3380,0
676,3380,0,3380,3,3383,0
677,3384,0,3384,3,3387,0
678,3388,0,3388,3,3391,0
678,3391,0,3391,3,3394,0
679,3391,3,3394,3,3397,1
680,3392,5,3397,3,3400,2
681,3399,1,3400,3,3403,1
680,3400,3,3403,3,3406,1
682,3405,1,3406,3,3409,1
681,3406,3,3409,3,3412,1
683,3409,3,3412,3,3415,1
682,3412,3,3415,3,3418,1
684,3413,5,3418,3,3421,2
682,3415,6,3421,3,3424,2
685,3421,3,3424,3,3427,1
686,3425,2,3427,3,3430,1
687,3427,3,3430,3,3433,1
688,3436,0,3436,3,3439,0
689,3439,0,3439,3,3442,0
690,3442,0,3442,3,3445,0
691,3452,0,3452,3,3455,0
692,3454,1,3455,3,3458,1
691,3455,3,3458,3,3461,1
691,3458,3,3461,3,3464,1
693,3458,6,3464,3,3467,2
694,3463,4,3467,3,3470,2
695,3473,0,3473,3,3476,0
696,3478,0,3478,3,3481,0
697,3483,0,3483,3,3486,0
698,3489,0,3489,3,3492,0
699,3494,0,3494,3,3497,0
699,3497,0,3497,3,3500,0
699,3500,0,3500,3,3503,0
700,3503,0,3503,3,3506,0
701,3510,0,3510,3,3513,0
702,3513,0,3513,3,3516,0
703,3515,1,3516,3,3519,1
704,3522,0,3522,3,3525,0
704,3525,0,3525,3,3528,0
705,3528,0,3528,3,3531,0
705,3531,0,3531,3,3534,0
706,3536,0,3536,3,3539,0
707,3538,1,3539,3,3542,1
708,3546,0,3546,3,3549,0
709,3552,0,3552,3,3555,0
710,3565,0,3565,3,3568,0
710,3568,0,3568,3,3571,0
711,3569,2,3571,3,3574,1
712,3578,0,3578,3,3581,0
712,3581,0,3581,3,3584,0
713,3585,0,3585,3,3588,0
714,3590,0,3590,3,3593,0
714,3593,0,3593,3,3596,0
714,3596,0,3596,3,3599,0
715,3598,1,3599,3,3602,1
716,3601,1,3602,3,3605,1
717,3612,0,3612,3,3615,0
717,3615,0,3615,3,3618,0
718,3622,0,3622,3,3625,0
718,3625,0,3625,3,3628,0
719,3627,1,3628,3,3631,1
718,3628,3,3631,3,3634,1
720,3628,6,3634,3,3637,2
721,3630,7,3637,3,3640,3
718,3631,9,3640,3,3643,3
718,3634,9,3643,3,3646,3
722,3638,8,3646,3,3649,3
719,3640,9,3649,3,3652,3
723,3642,10,3652,3,3655,4
719,3643,12,3655,3,3658,4
724,3645,13,3658,3,3661,5
725,3651,10,3661,3,3664,4
726,3654,10,3664,3,3667,4
722,3655,12,3667,3,3670,4
727,3664,6,3670,3,3673,2
725,3667,6,3673,3,3676,2
728,3668,8,3676,3,3679,3
729,3673,6,3679,3,3682,2
727,3676,6,3682,3,3685,2
730,3677,8,3685,3,3688,3
727,3679,9,3688,3,3691,3
731,3681,10,3691,3,3694,4
727,3682,12,3694,3,3697,4
732,3683,14,3697,3,3700,5
733,3688,12,3700,3,3703,4
729,3691,12,3703,3,3706,4
729,3694,12,3706,3,3709,4
734,3695,14,3709,3,3712,5
735,3697,15,3712,3,3715,5
730,3700,15,3715,3,3718,5
730,3703,15,3718,3,3721,5
736,3703,18,3721,3,3724,6
737,3705,19,3724,3,3727,7
732,3712,15,3727,3,3730,5
738,3712,18,3730,3,3733,6
732,3715,18,3733,3,3736,6
739,3715,21,3736,3,3739,7
732,3718,21,3739,3,3742,7
732,3721,21,3742,3,3745,7
740,3726,19,3745,3,3748,7
741,3728,20,3748,3,3751,7
742,3736,15,3751,3,3754,5
743,3740,14,3754,3,3757,5
744,3743,14,3757,3,3760,5
745,3747,13,3760,3,3763,5
746,3751,12,3763,3,3766,4
747,3755,11,3766,3,3769,4
748,3762,7,3769,3,3772,3
745,3763,9,3772,3,3775,3
749,3770,5,3775,3,3778,2
747,3772,6,3778,3,3781,2
750,3777,4,3781,3,3784,2
748,3778,6,3784,3,3787,2
748,3781,6,3787,3,3790,2
751,3781,9,3790,3,3793,3
752,3783,10,3793,3,3796,4
748,3784,12,3796,3,3799,4
753,3788,11,3799,3,3802,4
749,3790,12,3802,3,3805,4
754,3795,10,3805,3,3808,4
751,3799,9,3808,3,3811,3
751,3802,9,3811,3,3814,3
755,3803,11,3814,3,3817,4
756,3807,10,3817,3,3820,4
757,3810,10,3820,3,3823,4
758,3818,5,3823,3,3826,2
759,3821,5,3826,3,3829,2
757,3823,6,3829,3,3832,2
760,3825,7,3832,3,3835,3
759,3832,3,3835,3,3838,1
761,3837,1,3838,3,3841,1
760,3838,3,3841,3,3844,1
762,3842,2,3844,3,3847,1
763,3845,2,3847,3,3850,1
762,3847,3,3850,3,3853,1
762,3850,3,3853,3,3856,1
764,3851,5,3856,3,3859,2
765,3859,0,3859,3,3862,0
765,3862,0,3862,3,3865,0
766,3868,0,3868,3,3871,0
767,3873,0,3873,3,3876,0
768,3877,0,3877,3,3880,0
769,3884,0,3884,3,3887,0
770,3891,0,3891,3,3894,0
771,3896,0,3896,3,3899,0
771,3899,0,3899,3,3902,0
772,3900,2,3902,3,3905,1
773,3902,3,3905,3,3908,1
774,3903,5,3908,3,3911,2
775,3906,5,3911,3,3914,2
776,3910,4,3914,3,3917,2
777,3914,3,3917,3,3920,1
778,3920,0,3920,3,3923,0
779,3921,2,3923,3,3926,1
780,3922,4,3926,3,3929,2
778,3923,6,3929,3,3932,2
778,3926,6,3932,3,3935,2
781,3930,5,3935,3,3938,2
780,3935,3,3938,3,3941,1
782,3937,4,3941,3,3944,2
781,3941,3,3944,3,3947,1
783,3943,4,3947,3,3950,2
783,3950,0,3950,3,3953,0
784,3952,1,3953,3,3956,1
785,3955,1,3956,3,3959,1
786,3958,1,3959,3,3962,1
787,3962,0,3962,3,3965,0
788,3966,0,3966,3,3969,0
789,3970,0,3970,3,3973,0
790,3973,0,3973,3,3976,0
791,3975,1,3976,3,3979,1
791,3979,0,3979,3,3982,0
792,3981,1,3982,3,3985,1
791,3982,3,3985,3,3988,1
791,3985,3,3988,3,3991,1
793,3987,4,3991,3,3994,2
791,3988,6,3994,3,3997,2
794,3991,6,3997,3,4000,2
795,3995,5,4000,3,4003,2
796,4003,0,4003,3,4006,0
797,4009,0,4009,3,4012,0
798,4011,1,4012,3,4015,1
797,4012,3,4015,3,4018,1
797,4015,3,4018,3,4021,1
799,4017,4,4021,3,4024,2
798,4021,3,4024,3,4027,1
800,4025,2,4027,3,4030,1
801,4030,0,4030,3,4033,0
802,4035,0,4035,3,4038,0
803,4043,0,4043,3,4046,0
804,4046,0,4046,3,4049,0
804,4049,0,4049,3,4052,0
805,4051,1,4052,3,4055,1
806,4061,0,4061,3,4064,0
807,4066,0,4066,3,4069,0
807,4069,0,4069,3,4072,0
808,4072,0,4072,3,4075,0
808,4075,0,4075,3,4078,0
809,4077,1,4078,3,4081,1
810,4081,0,4081,3,4084,0
811,4085,0,4085,3,4088,0
812,4088,0,4088,3,4091,0
812,4091,0,4091,3,4094,0
813,4095,0,4095,3,4098,0
814,4101,0,4101,3,4104,0
815,4105,0,4105,3,4108,0
816,4110,0,4110,3,4113,0
817,4116,0,4116,3,4119,0
818,4123,0,4123,3,4126,0
819,4134,0,4134,3,4137,0
820,4143,0,4143,3,4146,0
821,4151,0,4151,3,4154,0
821,4154,0,4154,3,4157,0
822,4155,2,4157,3,4160,1
823,4161,0,4161,3,4164,0
824,4164,0,4164,3,4167,0
825,4175,0,4175,3,4178,0
826,4180,0,4180,3,4183,0
826,4183,0,4183,3,4186,0
827,4184,2,4186,3,4189,1
828,4192,0,4192,3,4195,0
829,4198,0,4198,3,4201,0
830,4203,0,4203,3,4206,0
831,4213,0,4213,3,4216,0
832,4221,0,4221,3,4224,0
833,4224,0,4224,3,4227,0
833,4227,0,4227,3,4230,0
834,4230,0,4230,3,4233,0
835,4235,0,4235,3,4238,0
836,4236,2,4238,3,4241,1
836,4241,0,4241,3,4244,0
837,4242,2,4244,3,4247,1
838,4245,2,4247,3,4250,1
839,4250,0,4250,3,4253,0
840,4255,0,4255,3,4258,0
840,4258,0,4258,3,4261,0
840,4261,0,4261,3,4264,0
841,4261,3,4264,3,4267,1
840,4264,3,4267,3,4270,1
840,4267,3,4270,3,4273,1
842,4268,5,4273,3,4276,2
843,4272,4,4276,3,4279,2
841,4273,6,4279,3,4282,2
842,4279,3,4282,3,4285,1
844,4280,5,4285,3,4288,2
845,4287,1,4288,3,4291,1
844,4288,3,4291,3,4294,1
846,4292,2,4294,3,4297,1
847,4297,0,4297,3,4300,0
847,4300,0,4300,3,4303,0
848,4307,0,4307,3,4310,0
848,4310,0,4310,3,4313,0
849,4312,1,4313,3,4316,1
848,4313,3,4316,3,4319,1
850,4314,5,4319,3,4322,2
851,4318,4,4322,3,4325,2
849,4319,6,4325,3,4328,2
852,4320,8,4328,3,4331,3
850,4325,6,4331,3,4334,2
853,4325,9,4334,3,4337,3
854,4330,7,4337,3,4340,3
855,4334,6,4340,3,4343,2
853,4337,6,4343,3,4346,2
856,4339,7,4346,3,4349,3
853,4340,9,4349,3,4352,3
857,4344,8,4352,3,4355,3
858,4347,8,4355,3,4358,3
859,4353,5,4358,3,4361,2
857,4355,6,4361,3,4364,2
860,4362,2,4364,3,4367,1
861,4368,0,4368,3,4371,0
861,4371,0,4371,3,4374,0
862,4375,0,4375,3,4378,0
862,4378,0,4378,3,4381,0
863,4380,1,4381,3,4384,1
862,4381,3,4384,3,4387,1
864,4385,2,4387,3,4390,1
865,4386,4,4390,3,4393,2
866,4392,1,4393,3,4396,1
865,4393,3,4396,3,4399,1
867,4397,2,4399,3,4402,1
866,4399,3,4402,3,4405,1
868,4399,6,4405,3,4408,2
866,4402,6,4408,3,4411,2
869,4404,7,4411,3,4414,3
870,4407,7,4414,3,4417,3
867,4408,9,4417,3,4420,3
871,4414,6,4420,3,4423,2
872,4416,7,4423,3,4426,3
869,4417,9,4426,3,4429,3
873,4422,7,4429,3,4432,3
874,4427,5,4432,3,4435,2
875,4432,3,4435,3,4438,1
876,4441,0,4441,3,4444,0
877,4450,0,4450,3,4453,0
878,4458,0,4458,3,4461,0
879,4463,0,4463,3,4466,0
880,4470,0,4470,3,4473,0
880,4473,0,4473,3,4476,0
880,4476,0,4476,3,4479,0
881,4477,2,4479,3,4482,1
882,4479,3,4482,3,4485,1
883,4485,0,4485,3,4488,0
883,4488,0,4488,3,4491,0
884,4494,0,4494,3,4497,0
885,4496,1,4497,3,4500,1
886,4500,0,4500,3,4503,0
887,4502,1,4503,3,4506,1
886,4503,3,4506,3,4509,1
888,4506,3,4509,3,4512,1
889,4507,5,4512,3,4515,2
888,4512,3,4515,3,4518,1
890,4513,5,4518,3,4521,2
888,4515,6,4521,3,4524,2
891,4519,5,4524,3,4527,2
892,4526,1,4527,3,4530,1
891,4527,3,4530,3,4533,1
893,4535,0,4535,3,4538,0
894,4538,0,4538,3,4541,0
894,4541,0,4541,3,4544,0
895,4548,0,4548,3,4551,0
896,4552,0,4552,3,4555,0
897,4556,0,4556,3,4559,0
898,4564,0,4564,3,4567,0
899,4567,0,4567,3,4570,0
900,4572,0,4572,3,4575,0
901,4574,1,4575,3,4578,1
902,4578,0,4578,3,4581,0
903,4583,0,4583,3,4586,0
904,4590,0,4590,3,4593,0
904,4593,0,4593,3,4596,0
905,4593,3,4596,3,4599,1
906,4600,0,4600,3,4603,0
907,4601,2,4603,3,4606,1
908,4605,1,4606,3,4609,1
909,4611,0,4611,3,4614,0
910,4615,0,4615,3,4618,0
911,4620,0,4620,3,4623,0
912,4626,0,4626,3,4629,0
913,4629,0,4629,3,4632,0
914,4631,1,4632,3,4635,1
914,4635,0,4635,3,4638,0
915,4636,2,4638,3,4641,1
916,4646,0,4646,3,4649,0
917,4653,0,4653,3,4656,0
917,4656,0,4656,3,4659,0
918,4656,3,4659,3,4662,1
917,4659,3,4662,3,4665,1
919,4660,5,4665,3,4668,2
920,4665,3,4668,3,4671,1
921,4667,4,4671,3,4674,2
921,4674,0,4674,3,4677,0
922,4675,2,4677,3,4680,1
921,4677,3,4680,3,4683,1
923,4679,4,4683,3,4686,2
924,4682,4,4686,3,4689,2
922,4683,6,4689,3,4692,2
925,4691,1,4692,3,4695,1
924,4692,3,4695,3,4698,1
926,4695,3,4698,3,4701,1
927,4700,1,4701,3,4704,1
928,4704,0,4704,3,4707,0
929,4706,1,4707,3,4710,1
930,4707,3,4710,3,4713,1
931,4709,4,4713,3,4716,2
932,4714,2,4716,3,4719,1
931,4716,3,4719,3,4722,1
933,4720,2,4722,3,4725,1
934,4728,0,4728,3,4731,0
935,4732,0,4732,3,4735,0
936,4735,0,4735,3,4738,0
937,4737,1,4738,3,4741,1
938,4744,0,4744,3,4747,0
939,4756,0,4756,3,4759,0
940,4758,1,4759,3,4762,1
940,4762,0,4762,3,4765,0
940,4765,0,4765,3,4768,0
941,4766,2,4768,3,4771,1
940,4768,3,4771,3,4774,1
942,4773,1,4774,3,4777,1
943,4780,0,4780,3,4783,0
944,4781,2,4783,3,4786,1
943,4783,3,4786,3,4789,1
945,4786,3,4789,3,4792,1
944,4789,3,4792,3,4795,1
944,4792,3,4795,3,4798,1
946,4792,6,4798,3,4801,2
947,4793,8,4801,3,4804,3
948,4797,7,4804,3,4807,3
949,4803,4,4807,3,4810,2
947,4804,6,4810,3,4813,2
950,4807,6,4813,3,4816,2
951,4810,6,4816,3,4819,2
952,4814,5,4819,3,4822,2
953,4816,6,4822,3,4825,2
954,4821,4,4825,3,4828,2
955,4830,0,4830,3,4833,0
956,4833,0,4833,3,4836,0
957,4839,0,4839,3,4842,0
958,4840,2,4842,3,4845,1
959,4841,4,4845,3,4848,2
960,4848,0,4848,3,4851,0
961,4850,1,4851,3,4854,1
960,4851,3,4854,3,4857,1
962,4856,1,4857,3,4860,1
963,4863,0,4863,3,4866,0
964,4868,0,4868,3,4871,0
964,4871,0,4871,3,4874,0
964,4874,0,4874,3,4877,0
965,4874,3,4877,3,4880,1
966,4880,0,4880,3,4883,0
967,4884,0,4884,3,4887,0
968,4889,0,4889,3,4892,0
969,4893,0,4893,3,4896,0
970,4898,0,4898,3,4901,0
971,4903,0,4903,3,4906,0
972,4906,0,4906,3,4909,0
973,4912,0,4912,3,4915,0
974,4919,0,4919,3,4922,0
975,4924,0,4924,3,4927,0
976,4929,0,4929,3,4932,0
976,4932,0,4932,3,4935,0
977,4936,0,4936,3,4939,0
977,4939,0,4939,3,4942,0
978,4940,2,4942,3,4945,1
979,4945,0,4945,3,4948,0
980,4957,0,4957,3,4960,0
981,4959,1,4960,3,4963,1
982,4964,0,4964,3,4967,0
983,4971,0,4971,3,4974,0
984,4977,0,4977,3,4980,0
985,4986,0,4986,3,4989,0
986,4989,0,4989,3,4992,0
987,4993,0,4993,3,4996,0
988,4995,1,4996,3,4999,1
989,4999,0,4999,3,5002,0
990,5005,0,5005,3,5008,0
991,5007,1,5008,3,5011,1
992,5014,0,5014,3,5017,0
992,5017,0,5017,3,5020,0
992,5020,0,5020,3,5023,0
993,5020,3,5023,3,5026,1
992,5023,3,5026,3,5029,1
994,5024,5,5029,3,5032,2
993,5029,3,5032,3,5035,1
995,5030,5,5035,3,5038,2
996,5036,2,5038,3,5041,1
997,5041,0,5041,3,5044,0
998,5047,0,5047,3,5050,0
998,5050,0,5050,3,5053,0
999,5050,3,5053,3,5056,1
999,5056,0,5056,3,5059,0
1000,5056,3,5059,3,5062,1
999,5059,3,5062,3,5065,1
1001,5059,6,5065,3,5068,2
999,5062,6,5068,3,5071,2
1002,5064,7,5071,3,5074,3
1003,5070,4,5074,3,5077,2
1004,5071,6,5077,3,5080,2
1005,5077,3,5080,3,5083,1
1006,5081,2,5083,3,5086,1
1007,5085,1,5086,3,5089,1
1006,5086,3,5089,3,5092,1
1008,5088,4,5092,3,5095,2
1009,5090,5,5095,3,5098,2
1007,5092,6,5098,3,5101,2
1010,5099,2,5101,3,5104,1
1011,5106,0,5106,3,5109,0
1012,5108,1,5109,3,5112,1
1011,5109,3,5112,3,5115,1
1013,5117,0,5117,3,5120,0
1014,5124,0,5124,3,5127,0
1015,5133,0,5133,3,5136,0
1016,5142,0,5142,3,5145,0
1017,5145,0,5145,3,5148,0
1018,5153,0,5153,3,5156,0
1019,5158,0,5158,3,5161,0
1020,5163,0,5163,3,5166,0
1021,5171,0,5171,3,5174,0
1022,5174,0,5174,3,5177,0
1023,5182,0,5182,3,5185,0
1024,5184,1,5185,3,5188,1
1025,5188,0,5188,3,5191,0
1026,5190,1,5191,3,5194,1
1025,5191,3,5194,3,5197,1
1027,5196,1,5197,3,5200,1
1028,5203,0,5203,3,5206,0
1028,5206,0,5206,3,5209,0
1029,5208,1,5209,3,5212,1
1030,5216,0,5216,3,5219,0
1030,5219,0,5219,3,5222,0
1031,5222,0,5222,3,5225,0
1032,5229,0,5229,3,5232,0
1033,5231,1,5232,3,5235,1
1032,5232,3,5235,3,5238,1
1034,5243,0,5243,3,5246,0
1035,5249,0,5249,3,5252,0
1035,5252,0,5252,3,5255,0
1036,5253,2,5255,3,5258,1
1037,5255,3,5258,3,5261,1
1038,5258,3,5261,3,5264,1
1039,5262,2,5264,3,5267,1
1040,5272,0,5272,3,5275,0
1041,5278,0,5278,3,5281,0
1042,5282,0,5282,3,5285,0
1042,5285,0,5285,3,5288,0
1043,5289,0,5289,3,5292,0
1043,5292,0,5292,3,5295,0
1044,5297,0,5297,3,5300,0
1045,5304,0,5304,3,5307,0
1045,5307,0,5307,3,5310,0
1046,5307,3,5310,3,5313,1
1046,5313,0,5313,3,5316,0
1047,5314,2,5316,3,5319,1
1048,5318,1,5319,3,5322,1
1049,5322,0,5322,3,5325,0
1050,5330,0,5330,3,5333,0
1051,5336,0,5336,3,5339,0
1052,5340,0,5340,3,5343,0
1053,5345,0,5345,3,5348,0
1054,5347,1,5348,3,5351,1
1055,5351,0,5351,3,5354,0
1056,5359,0,5359,3,5362,0
1057,5364,0,5364,3,5367,0
1058,5371,0,5371,3,5374,0
1059,5373,1,5374,3,5377,1
1060,5377,0,5377,3,5380,0
1060,5380,0,5380,3,5383,0
1061,5387,0,5387,3,5390,0
1061,5390,0,5390,3,5393,0
1062,5391,2,5393,3,5396,1
1063,5397,0,5397,3,5400,0
1064,5403,0,5403,3,5406,0
1065,5405,1,5406,3,5409,1
1066,5411,0,5411,3,5414,0
1067,5414,0,5414,3,5417,0
1068,5418,0,5418,3,5421,0
1069,5425,0,5425,3,5428,0
1070,5430,0,5430,3,5433,0
1070,5433,0,5433,3,5436,0
1071,5437,0,5437,3,5440,0
1072,5445,0,5445,3,5448,0
1073,5448,0,5448,3,5451,0
1074,5449,2,5451,3,5454,1
1075,5450,4,5454,3,5457,2
1076,5455,2,5457,3,5460,1
1077,5465,0,5465,3,5468,0
1078,5470,0,5470,3,5473,0
1079,5474,0,5474,3,5477,0
1080,5481,0,5481,3,5484,0
1081,5485,0,5485,3,5488,0
1082,5489,0,5489,3,5492,0
1083,5497,0,5497,3,5500,0
1083,5500,0,5500,3,5503,0
1084,5503,0,5503,3,5506,0
1085,5510,0,5510,3,5513,0
1086,5519,0,5519,3,5522,0
1087,5524,0,5524,3,5527,0
1088,5526,1,5527,3,5530,1
1089,5532,0,5532,3,5535,0
1090,5538,0,5538,3,5541,0
1091,5544,0,5544,3,5547,0
1091,5547,0,5547,3,5550,0
1092,5548,2,5550,3,5553,1
1091,5550,3,5553,3,5556,1
1093,5552,4,5556,3,5559,2
1092,5556,3,5559,3,5562,1
1092,5559,3,5562,3,5565,1
1094,5561,4,5565,3,5568,2
1092,5562,6,5568,3,5571,2
1095,5568,3,5571,3,5574,1
1096,5572,2,5574,3,5577,1
1097,5577,0,5577,3,5580,0
1098,5581,0,5581,3,5584,0
1099,5585,0,5585,3,5588,0
1099,5588,0,5588,3,5591,0
1100,5589,2,5591,3,5594,1
1101,5596,0,5596,3,5599,0
1102,5603,0,5603,3,5606,0
1103,5613,0,5613,3,5616,0
1103,5616,0,5616,3,5619,0
1104,5617,2,5619,3,5622,1
1105,5620,2,5622,3,5625,1
1106,5630,0,5630,3,5633,0
1107,5636,0,5636,3,5639,0
1108,5642,0,5642,3,5645,0
1109,5648,0,5648,3,5651,0
1110,5652,0,5652,3,5655,0
1111,5660,0,5660,3,5663,0
1112,5667,0,5667,3,5670,0
1112,5670,0,5670,3,5673,0
1113,5670,3,5673,3,5676,1
1114,5675,1,5676,3,5679,1
1115,5680,0,5680,3,5683,0
1115,5683,0,5683,3,5686,0
1116,5683,3,5686,3,5689,1
1117,5688,1,5689,3,5692,1
1117,5692,0,5692,3,5695,0
1118,5692,3,5695,3,5698,1
1119,5694,4,5698,3,5701,2
1119,5701,0,5701,3,5704,0
1120,5702,2,5704,3,5707,1
1119,5704,3,5707,3,5710,1
1121,5705,5,5710,3,5713,2
1122,5712,1,5713,3,5716,1
1123,5715,1,5716,3,5719,1
1122,5716,3,5719,3,5722,1
1122,5719,3,5722,3,5725,1
1124,5721,4,5725,3,5728,2
1125,5728,0,5728,3,5731,0
1126,5740,0,5740,3,5743,0
1127,5742,1,5743,3,5746,1
1128,5748,0,5748,3,5751,0
1129,5749,2,5751,3,5754,1
1128,5751,3,5754,3,5757,1
1130,5753,4,5757,3,5760,2
1131,5755,5,5760,3,5763,2
1132,5760,3,5763,3,5766,1
1133,5764,2,5766,3,5769,1
1134,5765,4,5769,3,5772,2
1135,5771,1,5772,3,5775,1
1136,5775,0,5775,3,5778,0
1136,5778,0,5778,3,5781,0
1137,5779,2,5781,3,5784,1
1136,5781,3,5784,3,5787,1
1138,5784,3,5787,3,5790,1
1139,5790,0,5790,3,5793,0
1140,5794,0,5794,3,5797,0
1140,5797,0,5797,3,5800,0
1141,5800,0,5800,3,5803,0
1142,5811,0,5811,3,5814,0
1142,5814,0,5814,3,5817,0
1143,5816,1,5817,3,5820,1
1144,5825,0,5825,3,5828,0
1145,5829,0,5829,3,5832,0
1146,5838,0,5838,3,5841,0
1147,5840,1,5841,3,5844,1
1147,5844,0,5844,3,5847,0
1148,5847,0,5847,3,5850,0
1148,5850,0,5850,3,5853,0
1149,5853,0,5853,3,5856,0
1149,5856,0,5856,3,5859,0
1150,5856,3,5859,3,5862,1
1151,5861,1,5862,3,5865,1
1152,5867,0,5867,3,5870,0
1153,5871,0,5871,3,5874,0
1154,5879,0,5879,3,5882,0
1155,5884,0,5884,3,5887,0
1155,5887,0,5887,3,5890,0
1156,5889,1,5890,3,5893,1
1155,5890,3,5893,3,5896,1
1157,5892,4,5896,3,5899,2
1158,5896,3,5899,3,5902,1
1159,5898,4,5902,3,5905,2
1160,5904,1,5905,3,5908,1
1161,5907,1,5908,3,5911,1
1161,5911,0,5911,3,5914,0
1162,5912,2,5914,3,5917,1
1161,5914,3,5917,3,5920,1
1163,5917,3,5920,3,5923,1
1164,5919,4,5923,3,5926,2
1165,5925,1,5926,3,5929,1
1164,5926,3,5929,3,5932,1
1166,5928,4,5932,3,5935,2
1167,5936,0,5936,3,5939,0
1167,5939,0,5939,3,5942,0
1168,5940,2,5942,3,5945,1
1167,5942,3,5945,3,5948,1
1169,5944,4,5948,3,5951,2
1170,5949,2,5951,3,5954,1
1169,5951,3,5954,3,5957,1
1169,5954,3,5957,3,5960,1
1171,5954,6,5960,3,5963,2
1172,5963,0,5963,3,5966,0
1172,5966,0,5966,3,5969,0
1173,5968,1,5969,3,5972,1
1174,5973,0,5973,3,5976,0
1175,5974,2,5976,3,5979,1
1176,5979,0,5979,3,5982,0
1177,5983,0,5983,3,5986,0
1178,5984,2,5986,3,5989,1
1177,5986,3,5989,3,5992,1
1179,5990,2,5992,3,5995,1
1180,5997,0,5997,3,6000,0
1181,6005,0,6005,3,6008,0
1182,6012,0,6012,3,6015,0
1182,6015,0,6015,3,6018,0
1183,6016,2,6018,3,6021,1
1182,6018,3,6021,3,6024,1
1184,6023,1,6024,3,6027,1
1185,6026,1,6027,3,6030,1
1185,6030,0,6030,3,6033,0
1186,6030,3,6033,3,6036,1
1187,6033,3,6036,3,6039,1
1186,6036,3,6039,3,6042,1
1188,6036,6,6042,3,6045,2
1189,6040,5,6045,3,6048,2
1190,6045,3,6048,3,6051,1
1191,6049,2,6051,3,6054,1
1192,6051,3,6054,3,6057,1
1193,6053,4,6057,3,6060,2
1193,6060,0,6060,3,6063,0
1194,6060,3,6063,3,6066,1
1194,6066,0,6066,3,6069,0
1195,6068,1,6069,3,6072,1
1196,6070,2,6072,3,6075,1
1197,6077,0,6077,3,6080,0
1197,6080,0,6080,3,6083,0
1198,6080,3,6083,3,6086,1
1199,6083,3,6086,3,6089,1
1200,6087,2,6089,3,6092,1
1200,6092,0,6092,3,6095,0
1201,6095,0,6095,3,6098,0
1201,6098,0,6098,3,6101,0
1202,6099,2,6101,3,6104,1
1203,6104,0,6104,3,6107,0
1203,6107,0,6107,3,6110,0
1204,6108,2,6110,3,6113,1
1205,6112,1,6113,3,6116,1
1205,6116,0,6116,3,6119,0
1206,6118,1,6119,3,6122,1
1205,6119,3,6122,3,6125,1
1207,6121,4,6125,3,6128,2
1205,6122,6,6128,3,6131,2
1208,6130,1,6131,3,6134,1
1209,6135,0,6135,3,6138,0
1210,6143,0,6143,3,6146,0
1211,6146,0,6146,3,6149,0
1212,6155,0,6155,3,6158,0
1213,6160,0,6160,3,6163,0
1214,6170,0,6170,3,6173,0
1215,6176,0,6176,3,6179,0
1216,6180,0,6180,3,6183,0
1216,6183,0,6183,3,6186,0
1217,6188,0,6188,3,6191,0
1217,6191,0,6191,3,6194,0
1217,6194,0,6194,3,6197,0
1218,6195,2,6197,3,6200,1
1219,6200,0,6200,3,6203,0
1220,6205,0,6205,3,6208,0
1221,6215,0,6215,3,6218,0
1221,6218,0,6218,3,6221,0
1222,6219,2,6221,3,6224,1
1223,6222,2,6224,3,6227,1
1224,6223,4,6227,3,6230,2
1222,6224,6,6230,3,6233,2
1225,6228,5,6233,3,6236,2
1226,6234,2,6236,3,6239,1
1225,6236,3,6239,3,6242,1
1227,6238,4,6242,3,6245,2
1228,6242,3,6245,3,6248,1
1229,6247,1,6248,3,6251,1
1230,6254,0,6254,3,6257,0
1231,6258,0,6258,3,6261,0
1232,6261,0,6261,3,6264,0
1233,6266,0,6266,3,6269,0
1234,6274,0,6274,3,6277,0
1235,6277,0,6277,3,6280,0
1235,6280,0,6280,3,6283,0
1235,6283,0,6283,3,6286,0
1236,6286,0,6286,3,6289,0
1236,6289,0,6289,3,6292,0
1236,6292,0,6292,3,6295,0
1237,6296,0,6296,3,6299,0
1237,6299,0,6299,3,6302,0
1238,6301,1,6302,3,6305,1
1237,6302,3,6305,3,6308,1
1237,6305,3,6308,3,6311,1
1239,6307,4,6311,3,6314,2
1240,6311,3,6314,3,6317,1
1239,6314,3,6317,3,6320,1
1241,6316,4,6320,3,6323,2
1242,6318,5,6323,3,6326,2
1240,6320,6,6326,3,6329,2
1243,6328,1,6329,3,6332,1
1244,6331,1,6332,3,6335,1
1243,6332,3,6335,3,6338,1
1245,6334,4,6338,3,6341,2
1246,6338,3,6341,3,6344,1
1247,6343,1,6344,3,6347,1
1248,6346,1,6347,3,6350,1
1247,6347,3,6350,3,6353,1
1249,6350,3,6353,3,6356,1
1250,6358,0,6358,3,6361,0
1250,6361,0,6361,3,6364,0
1251,6364,0,6364,3,6367,0
1252,6368,0,6368,3,6371,0
1252,6371,0,6371,3,6374,0
1253,6374,0,6374,3,6377,0
1254,6378,0,6378,3,6381,0
1255,6378,3,6381,3,6384,1
1256,6380,4,6384,3,6387,2
1256,6387,0,6387,3,6390,0
1257,6389,1,6390,3,6393,1
1258,6391,2,6393,3,6396,1
1259,6396,0,6396,3,6399,0
1260,6400,0,6400,3,6403,0
1261,6403,0,6403,3,6406,0
1262,6404,2,6406,3,6409,1
1261,6406,3,6409,3,6412,1
1263,6407,5,6412,3,6415,2
1264,6409,6,6415,3,6418,2
1265,6412,6,6418,3,6421,2
1263,6415,6,6421,3,6424,2
1266,6415,9,6424,3,6427,3
1267,6418,9,6427,3,6430,3
1265,6424,6,6430,3,6433,2
1268,6424,9,6433,3,6436,3
1265,6427,9,6436,3,6439,3
1269,6431,8,6439,3,6442,3
1266,6433,9,6442,3,6445,3
1270,6438,7,6445,3,6448,3
1271,6443,5,6448,3,6451,2
1269,6445,6,6451,3,6454,2
1272,6445,9,6454,3,6457,3
1270,6451,6,6457,3,6460,2
1273,6451,9,6460,3,6463,3
1274,6456,7,6463,3,6466,3
1272,6460,6,6466,3,6469,2
1275,6461,8,6469,3,6472,3
1272,6463,9,6472,3,6475,3
1272,6466,9,6475,3,6478,3
1276,6466,12,6478,3,6481,4
1277,6467,14,6481,3,6484,5
1272,6469,15,6484,3,6487,5
1278,6469,18,6487,3,6490,6
1279,6473,17,6490,3,6493,6
1280,6477,16,6493,3,6496,6
1281,6483,13,6496,3,6499,5
1276,6484,15,6499,3,6502,5
1282,6486,16,6502,3,6505,6
1276,6487,18,6505,3,6508,6
1276,6490,18,6508,3,6511,6
1283,6493,18,6511,3,6514,6
1284,6497,17,6514,3,6517,6
1285,6499,18,6517,3,6520,6
1286,6500,20,6520,3,6523,7
1287,6503,20,6523,3,6526,7
1288,6507,19,6526,3,6529,7
1281,6508,21,6529,3,6532,7
1282,6514,18,6532,3,6535,6
1289,6515,20,6535,3,6538,7
1290,6520,18,6538,3,6541,6
1291,6523,18,6541,3,6544,6
1292,6523,21,6544,3,6547,7
1286,6529,18,6547,3,6550,6
1293,6530,20,6550,3,6553,7
1294,6532,21,6553,3,6556,7
1287,6535,21,6556,3,6559,7
1287,6538,21,6559,3,6562,7
1295,6538,24,6562,3,6565,8
1296,6543,22,6565,3,6568,8
1290,6550,18,6568,3,6571,6
1297,6550,21,6571,3,6574,7
1298,6556,18,6574,3,6577,6
1293,6562,15,6577,3,6580,5
1299,6563,17,6580,3,6583,6
1293,6565,18,6583,3,6586,6
1300,6572,14,6586,3,6589,5
1301,6575,14,6589,3,6592,5
1296,6577,15,6592,3,6595,5
1302,6578,17,6595,3,6598,6
1296,6580,18,6598,3,6601,6
1296,6583,18,6601,3,6604,6
1303,6583,21,6604,3,6607,7
1304,6587,20,6607,3,6610,7
1305,6590,20,6610,3,6613,7
1298,6592,21,6613,3,6616,7
1306,6592,24,6616,3,6619,8
1307,6595,24,6619,3,6622,8
1299,6598,24,6622,3,6625,8
1308,6601,24,6625,3,6628,8
1309,6604,24,6628,3,6631,8
1310,6612,19,6631,3,6634,7
1303,6613,21,6634,3,6637,7
1311,6620,17,6637,3,6640,6
1312,6624,16,6640,3,6643,6
1306,6625,18,6643,3,6646,6
1313,6631,15,6646,3,6649,5
1314,6633,16,6649,3,6652,6
1315,6638,14,6652,3,6655,5
1316,6642,13,6655,3,6658,5
1317,6645,13,6658,3,6661,5
1318,6648,13,6661,3,6664,5
1313,6649,15,6664,3,6667,5
1319,6651,16,6667,3,6670,6
1320,6660,10,6670,3,6673,4
1317,6664,9,6673,3,6676,3
1321,6667,9,6676,3,6679,3
1322,6674,5,6679,3,6682,2
1323,6676,6,6682,3,6685,2
1324,6680,5,6685,3,6688,2
1325,6682,6,6688,3,6691,2
1326,6683,8,6691,3,6694,3
1323,6685,9,6694,3,6697,3
1327,6690,7,6697,3,6700,3
1328,6698,2,6700,3,6703,1
1329,6707,0,6707,3,6710,0
1330,6712,0,6712,3,6715,0
1331,6717,0,6717,3,6720,0
1332,6724,0,6724,3,6727,0
1333,6729,0,6729,3,6732,0
1334,6737,0,6737,3,6740,0
1335,6745,0,6745,3,6748,0
1336,6747,1,6748,3,6751,1
1337,6747,4,6751,3,6754,2
1338,6751,3,6754,3,6757,1
1339,6754,3,6757,3,6760,1
1338,6757,3,6760,3,6763,1
1340,6761,2,6763,3,6766,1
1341,6771,0,6771,3,6774,0
1342,6773,1,6774,3,6777,1
1341,6774,3,6777,3,6780,1
1343,6779,1,6780,3,6783,1
1342,6780,3,6783,3,6786,1
1344,6784,2,6786,3,6789,1
1343,6786,3,6789,3,6792,1
1345,6787,5,6792,3,6795,2
1346,6793,2,6795,3,6798,1
1346,6798,0,6798,3,6801,0
1347,6799,2,6801,3,6804,1
1348,6801,3,6804,3,6807,1
1347,6804,3,6807,3,6810,1
1349,6810,0,6810,3,6813,0
1350,6811,2,6813,3,6816,1
1351,6814,2,6816,3,6819,1
1350,6816,3,6819,3,6822,1
1352,6818,4,6822,3,6825,2
1351,6822,3,6825,3,6828,1
1353,6825,3,6828,3,6831,1
1354,6829,2,6831,3,6834,1
1355,6835,0,6835,3,6838,0
1355,6838,0,6838,3,6841,0
1355,6841,0,6841,3,6844,0
1356,6841,3,6844,3,6847,1
1357,6842,5,6847,3,6850,2
1358,6849,1,6850,3,6853,1
1357,6850,3,6853,3,6856,1
1359,6852,4,6856,3,6859,2
1358,6856,3,6859,3,6862,1
1360,6858,4,6862,3,6865,2
1358,6859,6,6865,3,6868,2
1361,6861,7,6868,3,6871,3
1359,6865,6,6871,3,6874,2
1362,6865,9,6874,3,6877,3
1360,6871,6,6877,3,6880,2
1363,6872,8,6880,3,6883,3
1364,6874,9,6883,3,6886,3
1362,6880,6,6886,3,6889,2
1365,6880,9,6889,3,6892,3
1366,6887,5,6892,3,6895,2
1366,6895,0,6895,3,6898,0
1367,6895,3,6898,3,6901,1
1366,6898,3,6901,3,6904,1
1368,6899,5,6904,3,6907,2
1369,6904,3,6907,3,6910,1
1370,6909,1,6910,3,6913,1
1370,6913,0,6913,3,6916,0
1370,6916,0,6916,3,6919,0
1371,6918,1,6919,3,6922,1
1370,6919,3,6922,3,6925,1
1371,6925,0,6925,3,6928,0
1372,6925,3,6928,3,6931,1
1373,6931,0,6931,3,6934,0
1373,6934,0,6934,3,6937,0
1374,6936,1,6937,3,6940,1
1375,6942,0,6942,3,6945,0
1376,6948,0,6948,3,6951,0
1377,6951,0,6951,3,6954,0
1377,6954,0,6954,3,6957,0
1378,6956,1,6957,3,6960,1
1379,6958,2,6960,3,6963,1
1378,6960,3,6963,3,6966,1
1378,6963,3,6966,3,6969,1
1380,6963,6,6969,3,6972,2
1381,6968,4,6972,3,6975,2
1382,6976,0,6976,3,6979,0
1383,6983,0,6983,3,6986,0
1383,6986,0,6986,3,6989,0
1384,6989,0,6989,3,6992,0
1385,6994,0,6994,3,6997,0
1386,6997,0,6997,3,7000,0
1387,7003,0,7003,3,7006,0
1388,7008,0,7008,3,7011,0
1389,7021,0,7021,3,7024,0
1390,7030,0,7030,3,7033,0
1391,7037,0,7037,3,7040,0
1392,7042,0,7042,3,7045,0
1392,7045,0,7045,3,7048,0
1393,7047,1,7048,3,7051,1
1393,7051,0,7051,3,7054,0
1394,7051,3,7054,3,7057,1
1393,7054,3,7057,3,7060,1
1395,7054,6,7060,3,7063,2
1396,7061,2,7063,3,7066,1
1396,7066,0,7066,3,7069,0
1397,7068,1,7069,3,7072,1
1396,7069,3,7072,3,7075,1
1397,7075,0,7075,3,7078,0
1398,7078,0,7078,3,7081,0
1399,7084,0,7084,3,7087,0
1400,7087,0,7087,3,7090,0
1401,7090,0,7090,3,7093,0
1401,7093,0,7093,3,7096,0
1401,7096,0,7096,3,7099,0
1402,7096,3,7099,3,7102,1
1403,7100,2,7102,3,7105,1
1404,7106,0,7106,3,7109,0
1405,7108,1,7109,3,7112,1
1406,7115,0,7115,3,7118,0
1407,7122,0,7122,3,7125,0
1408,7126,0,7126,3,7129,0
1409,7137,0,7137,3,7140,0
1409,7140,0,7140,3,7143,0
1410,7144,0,7144,3,7147,0
1411,7146,1,7147,3,7150,1
1412,7152,0,7152,3,7155,0
1412,7155,0,7155,3,7158,0
1413,7155,3,7158,3,7161,1
1412,7158,3,7161,3,7164,1
1414,7160,4,7164,3,7167,2
1415,7161,6,7167,3,7170,2
1416,7167,3,7170,3,7173,1
1416,7173,0,7173,3,7176,0
1417,7174,2,7176,3,7179,1
1418,7182,0,7182,3,7185,0
1418,7185,0,7185,3,7188,0
1419,7185,3,7188,3,7191,1
1418,7188,3,7191,3,7194,1
1420,7190,4,7194,3,7197,2
1421,7196,1,7197,3,7200,1
1420,7197,3,7200,3,7203,1
1422,7201,2,7203,3,7206,1
1423,7203,3,7206,3,7209,1
1424,7207,2,7209,3,7212,1
1423,7209,3,7212,3,7215,1
1424,7215,0,7215,3,7218,0
1425,7215,3,7218,3,7221,1
1426,7217,4,7221,3,7224,2
1425,7221,3,7224,3,7227,1
1427,7224,3,7227,3,7230,1
1428,7227,3,7230,3,7233,1
1429,7229,4,7233,3,7236,2
1430,7234,2,7236,3,7239,1
1429,7236,3,7239,3,7242,1
1431,7243,0,7243,3,7246,0
1432,7246,0,7246,3,7249,0
1433,7250,0,7250,3,7253,0
1433,7253,0,7253,3,7256,0
1434,7256,0,7256,3,7259,0
1434,7259,0,7259,3,7262,0
1435,7259,3,7262,3,7265,1
1436,7268,0,7268,3,7271,0
1437,7274,0,7274,3,7277,0
1438,7279,0,7279,3,7282,0
1438,7282,0,7282,3,7285,0
1439,7286,0,7286,3,7289,0
1439,7289,0,7289,3,7292,0
1440,7289,3,7292,3,7295,1
1441,7293,2,7295,3,7298,1
1442,7296,2,7298,3,7301,1
1443,7300,1,7301,3,7304,1
1443,7304,0,7304,3,7307,0
1444,7306,1,7307,3,7310,1
1443,7307,3,7310,3,7313,1
1445,7311,2,7313,3,7316,1
1446,7316,0,7316,3,7319,0
1447,7320,0,7320,3,7323,0
1447,7323,0,7323,3,7326,0
1448,7327,0,7327,3,7330,0
1449,7334,0,7334,3,7337,0
1449,7337,0,7337,3,7340,0
1450,7339,1,7340,3,7343,1
1449,7340,3,7343,3,7346,1
1451,7344,2,7346,3,7349,1
1450,7346,3,7349,3,7352,1
1450,7349,3,7352,3,7355,1
1452,7349,6,7355,3,7358,2
1453,7357,1,7358,3,7361,1
1454,7368,0,7368,3,7371,0
1455,7373,0,7373,3,7376,0
1456,7377,0,7377,3,7380,0
1457,7384,0,7384,3,7387,0
1457,7387,0,7387,3,7390,0
1458,7388,2,7390,3,7393,1
1459,7396,0,7396,3,7399,0
1459,7399,0,7399,3,7402,0
1459,7402,0,7402,3,7405,0
1460,7402,3,7405,3,7408,1
1461,7407,1,7408,3,7411,1
1462,7412,0,7412,3,7415,0
1462,7415,0,7415,3,7418,0
1463,7417,1,7418,3,7421,1
1464,7423,0,7423,3,7426,0
1465,7425,1,7426,3,7429,1
1466,7426,3,7429,3,7432,1
1465,7429,3,7432,3,7435,1
1467,7432,3,7435,3,7438,1
1468,7438,0,7438,3,7441,0
1468,7441,0,7441,3,7444,0
1469,7442,2,7444,3,7447,1
1468,7444,3,7447,3,7450,1
1470,7446,4,7450,3,7453,2
1471,7451,2,7453,3,7456,1
1472,7457,0,7457,3,7460,0
1473,7464,0,7464,3,7467,0
1474,7470,0,7470,3,7473,0
1475,7476,0,7476,3,7479,0
1476,7477,2,7479,3,7482,1
1477,7480,2,7482,3,7485,1
1477,7485,0,7485,3,7488,0
1477,7488,0,7488,3,7491,0
1478,7490,1,7491,3,7494,1
1478,7494,0,7494,3,7497,0
1478,7497,0,7497,3,7500,0
1479,7499,1,7500,3,7503,1
1478,7500,3,7503,3,7506,1
1478,7503,3,7506,3,7509,1
1480,7505,4,7509,3,7512,2
1481,7508,4,7512,3,7515,2
1482,7512,3,7515,3,7518,1
1481,7515,3,7518,3,7521,1
1483,7516,5,7521,3,7524,2
1484,7520,4,7524,3,7527,2
1485,7525,2,7527,3,7530,1
1484,7527,3,7530,3,7533,1
1486,7532,1,7533,3,7536,1
1485,7533,3,7536,3,7539,1
1487,7537,2,7539,3,7542,1
1487,7542,0,7542,3,7545,0
1488,7543,2,7545,3,7548,1
1487,7545,3,7548,3,7551,1
1489,7547,4,7551,3,7554,2
1488,7551,3,7554,3,7557,1
1490,7553,4,7557,3,7560,2
1491,7557,3,7560,3,7563,1
1491,7563,0,7563,3,7566,0
1492,7563,3,7566,3,7569,1
1493,7570,0,7570,3,7573,0
1493,7573,0,7573,3,7576,0
1494,7576,0,7576,3,7579,0
1495,7581,0,7581,3,7584,0
1496,7587,0,7587,3,7590,0
1497,7593,0,7593,3,7596,0
1498,7595,1,7596,3,7599,1
1499,7604,0,7604,3,7607,0
1499,7607,0,7607,3,7610,0
1500,7612,0,7612,3,7615,0
1501,7616,0,7616,3,7619,0
1501,7619,0,7619,3,7622,0
1502,7621,1,7622,3,7625,1
1501,7622,3,7625,3,7628,1
1503,7622,6,7628,3,7631,2
1501,7625,6,7631,3,7634,2
1504,7626,8,7634,3,7637,3
1505,7630,7,7637,3,7640,3
1502,7631,9,7640,3,7643,3
1506,7635,8,7643,3,7646,3
1507,7635,11,7646,3,7649,4
1503,7637,12,7649,3,7652,4
1508,7641,11,7652,3,7655,4
1509,7645,10,7655,3,7658,4
1506,7649,9,7658,3,7661,3
1510,7651,10,7661,3,7664,4
1506,7652,12,7664,3,7667,4
1511,7655,12,7667,3,7670,4
1512,7659,11,7670,3,7673,4
1508,7661,12,7673,3,7676,4
1513,7663,13,7676,3,7679,5
1508,7664,15,7679,3,7682,5
1514,7665,17,7682,3,7685,6
1515,7668,17,7685,3,7688,6
1509,7670,18,7688,3,7691,6
1516,7672,19,7691,3,7694,7
1517,7676,18,7694,3,7697,6
1512,7682,15,7697,3,7700,5
1518,7684,16,7700,3,7703,6
1519,7692,11,7703,3,7706,4
1520,7697,9,7706,3,7709,3
1521,7702,7,7709,3,7712,3
1518,7703,9,7712,3,7715,3
1522,7708,7,7715,3,7718,3
1523,7711,7,7718,3,7721,3
1520,7712,9,7721,3,7724,3
1524,7712,12,7724,3,7727,4
1525,7717,10,7727,3,7730,4
1522,7721,9,7730,3,7733,3
1526,7722,11,7733,3,7736,4
1522,7724,12,7736,3,7739,4
1527,7725,14,7739,3,7742,5
1528,7729,13,7742,3,7745,5
1524,7733,12,7745,3,7748,4
1529,7738,10,7748,3,7751,4
1530,7743,8,7751,3,7754,3
1528,7748,6,7754,3,7757,2
1531,7749,8,7757,3,7760,3
1528,7751,9,7760,3,7763,3
1532,7752,11,7763,3,7766,4
1533,7757,9,7766,3,7769,3
1534,7765,4,7769,3,7772,2
1535,7766,6,7772,3,7775,2
1533,7769,6,7775,3,7778,2
1533,7772,6,7778,3,7781,2
1536,7772,9,7781,3,7784,3
1537,7778,6,7784,3,7787,2
1538,7784,3,7787,3,7790,1
1539,7791,0,7791,3,7794,0
1540,7795,0,7795,3,7798,0
1540,7798,0,7798,3,7801,0
1541,7799,2,7801,3,7804,1
1542,7803,1,7804,3,7807,1
1541,7804,3,7807,3,7810,1
1543,7810,0,7810,3,7813,0
1543,7813,0,7813,3,7816,0
1543,7816,0,7816,3,7819,0
1544,7817,2,7819,3,7822,1
1545,7820,2,7822,3,7825,1
1546,7820,5,7825,3,7828,2
1547,7825,3,7828,3,7831,1
1546,7828,3,7831,3,7834,1
1546,7831,3,7834,3,7837,1
1548,7831,6,7837,3,7840,2
1549,7838,2,7840,3,7843,1
1550,7848,0,7848,3,7851,0
1551,7852,0,7852,3,7855,0
1551,7855,0,7855,3,7858,0
1552,7858,0,7858,3,7861,0
1553,7862,0,7862,3,7865,0
1554,7869,0,7869,3,7872,0
1555,7874,0,7874,3,7877,0
1555,7877,0,7877,3,7880,0
1556,7879,1,7880,3,7883,1
1555,7880,3,7883,3,7886,1
1557,7886,0,7886,3,7889,0
1558,7889,0,7889,3,7892,0
1558,7892,0,7892,3,7895,0
1559,7895,0,7895,3,7898,0
1559,7898,0,7898,3,7901,0
1560,7898,3,7901,3,7904,1
1559,7901,3,7904,3,7907,1
1561,7902,5,7907,3,7910,2
1560,7907,3,7910,3,7913,1
1562,7907,6,7913,3,7916,2
1563,7912,4,7916,3,7919,2
1564,7915,4,7919,3,7922,2
1565,7917,5,7922,3,7925,2
1563,7919,6,7925,3,7928,2
1563,7922,6,7928,3,7931,2
1566,7922,9,7931,3,7934,3
1567,7926,8,7934,3,7937,3
1568,7927,10,7937,3,7940,4
1564,7928,12,7940,3,7943,4
1569,7929,14,7943,3,7946,5
1570,7933,13,7946,3,7949,5
1571,7936,13,7949,3,7952,5
1566,7937,15,7952,3,7955,5
1572,7939,16,7955,3,7958,6
1566,7940,18,7958,3,7961,6
1573,7942,19,7961,3,7964,7
1568,7949,15,7964,3,7967,5
1574,7951,16,7967,3,7970,6
1575,7953,17,7970,3,7973,6
1570,7958,15,7973,3,7976,5
1576,7960,16,7976,3,7979,6
1577,7965,14,7979,3,7982,5
1578,7969,13,7982,3,7985,5
1573,7970,15,7985,3,7988,5
1579,7972,16,7988,3,7991,6
1580,7977,14,7991,3,7994,5
1581,7984,10,7994,3,7997,4
1582,7986,11,7997,3,8000,4
1578,7988,12,8000,3,8003,4
1578,7991,12,8003,3,8006,4
1583,7991,15,8006,3,8009,5
1584,7991,18,8009,3,8012,6
1585,7999,13,8012,3,8015,5
1580,8000,15,8015,3,8018,5
1580,8003,15,8018,3,8021,5
1586,8003,18,8021,3,8024,6
1587,8005,19,8024,3,8027,7
1588,8007,20,8027,3,8030,7
1589,8014,16,8030,3,8033,6
1585,8021,12,8033,3,8036,4
1590,8021,15,8036,3,8039,5
1586,8027,12,8039,3,8042,4
1591,8029,13,8042,3,8045,5
1592,8035,10,8045,3,8048,4
1588,8036,12,8048,3,8051,4
1593,8039,12,8051,3,8054,4
1594,8049,5,8054,3,8057,2
1595,8058,0,8058,3,8061,0
1596,8060,1,8061,3,8064,1
1597,8064,0,8064,3,8067,0
1598,8066,1,8067,3,8070,1
1597,8067,3,8070,3,8073,1
1597,8070,3,8073,3,8076,1
1599,8074,2,8076,3,8079,1
1600,8078,1,8079,3,8082,1
1599,8079,3,8082,3,8085,1
1601,8082,3,8085,3,8088,1
1601,8088,0,8088,3,8091,0
1602,8090,1,8091,3,8094,1
1603,8093,1,8094,3,8097,1
1604,8101,0,8101,3,8104,0
1605,8103,1,8104,3,8107,1
1606,8107,0,8107,3,8110,0
1607,8113,0,8113,3,8116,0
1608,8114,2,8116,3,8119,1
1609,8116,3,8119,3,8122,1
1610,8125,0,8125,3,8128,0
1611,8132,0,8132,3,8135,0
1611,8135,0,8135,3,8138,0
1612,8139,0,8139,3,8142,0
1612,8142,0,8142,3,8145,0
1613,8142,3,8145,3,8148,1
1613,8148,0,8148,3,8151,0
1614,8151,0,8151,3,8154,0
1614,8154,0,8154,3,8157,0
1615,8157,0,8157,3,8160,0
1616,8161,0,8161,3,8164,0
1617,8165,0,8165,3,8168,0
1618,8167,1,8168,3,8171,1
1618,8171,0,8171,3,8174,0
1619,8174,0,8174,3,8177,0
1620,8176,1,8177,3,8180,1
1621,8183,0,8183,3,8186,0
1622,8189,0,8189,3,8192,0
1623,8195,0,8195,3,8198,0
1624,8200,0,8200,3,8203,0
1624,8203,0,8203,3,8206,0
1625,8204,2,8206,3,8209,1
1624,8206,3,8209,3,8212,1
1626,8207,5,8212,3,8215,2
1625,8212,3,8215,3,8218,1
1627,8214,4,8218,3,8221,2
1628,8219,2,8221,3,8224,1
1628,8224,0,8224,3,8227,0
1629,8225,2,8227,3,8230,1
1630,8229,1,8230,3,8233,1
1629,8230,3,8233,3,8236,1
1629,8233,3,8236,3,8239,1
1629,8236,3,8239,3,8242,1
1631,8237,5,8242,3,8245,2
1629,8239,6,8245,3,8248,2
1632,8247,1,8248,3,8251,1
1633,8252,0,8252,3,8255,0
1633,8255,0,8255,3,8258,0
1634,8256,2,8258,3,8261,1
1635,8261,0,8261,3,8264,0
1636,8268,0,8268,3,8271,0
1637,8271,0,8271,3,8274,0
1638,8276,0,8276,3,8279,0
1639,8278,1,8279,3,8282,1
1640,8279,3,8282,3,8285,1
1641,8286,0,8286,3,8289,0
1642,8291,0,8291,3,8294,0
1643,8296,0,8296,3,8299,0
1644,8298,1,8299,3,8302,1
1644,8302,0,8302,3,8305,0
1644,8305,0,8305,3,8308,0
1645,8305,3,8308,3,8311,1
1646,8307,4,8311,3,8314,2
1645,8311,3,8314,3,8317,1
1647,8312,5,8317,3,8320,2
1648,8323,0,8323,3,8326,0
1648,8326,0,8326,3,8329,0
1649,8332,0,8332,3,8335,0
1650,8333,2,8335,3,8338,1
1651,8339,0,8339,3,8342,0
1652,8341,1,8342,3,8345,1
1653,8344,1,8345,3,8348,1
1654,8347,1,8348,3,8351,1
1655,8350,1,8351,3,8354,1
1654,8351,3,8354,3,8357,1
1656,8355,2,8357,3,8360,1
1657,8359,1,8360,3,8363,1
1656,8360,3,8363,3,8366,1
1656,8363,3,8366,3,8369,1
1658,8367,2,8369,3,8372,1
1658,8372,0,8372,3,8375,0
1659,8374,1,8375,3,8378,1
1658,8375,3,8378,3,8381,1
1660,8381,0,8381,3,8384,0
1661,8389,0,8389,3,8392,0
1662,8390,2,8392,3,8395,1
1661,8392,3,8395,3,8398,1
1663,8396,2,8398,3,8401,1
1662,8398,3,8401,3,8404,1
1662,8401,3,8404,3,8407,1
1664,8403,4,8407,3,8410,2
1665,8406,4,8410,3,8413,2
1663,8407,6,8413,3,8416,2
1666,8411,5,8416,3,8419,2
1667,8414,5,8419,3,8422,2
1665,8416,6,8422,3,8425,2
1668,8419,6,8425,3,8428,2
1669,8425,3,8428,3,8431,1
1670,8430,1,8431,3,8434,1
1671,8436,0,8436,3,8439,0
1671,8439,0,8439,3,8442,0
1672,8442,0,8442,3,8445,0
1673,8445,0,8445,3,8448,0
1674,8447,1,8448,3,8451,1
1673,8448,3,8451,3,8454,1
1675,8453,1,8454,3,8457,1
1676,8457,0,8457,3,8460,0
1677,8462,0,8462,3,8465,0
1677,8465,0,8465,3,8468,0
1678,8467,1,8468,3,8471,1
1677,8468,3,8471,3,8474,1
1677,8471,3,8474,3,8477,1
1679,8471,6,8477,3,8480,2
1680,8477,3,8480,3,8483,1
1681,8480,3,8483,3,8486,1
1682,8483,3,8486,3,8489,1
1683,8488,1,8489,3,8492,1
1682,8489,3,8492,3,8495,1
1684,8492,3,8495,3,8498,1
1685,8493,5,8498,3,8501,2
1686,8497,4,8501,3,8504,2
1687,8501,3,8504,3,8507,1
1686,8504,3,8507,3,8510,1
1688,8504,6,8510,3,8513,2
1689,8509,4,8513,3,8516,2
1687,8510,6,8516,3,8519,2
1690,8513,6,8519,3,8522,2
1691,8516,6,8522,3,8525,2
1692,8521,4,8525,3,8528,2
1690,8522,6,8528,3,8531,2
1691,8528,3,8531,3,8534,1
1693,8530,4,8534,3,8537,2
1694,8535,2,8537,3,8540,1
1695,8540,0,8540,3,8543,0
1696,8545,0,8545,3,8548,0
1697,8548,0,8548,3,8551,0
1698,8557,0,8557,3,8560,0
1699,8561,0,8561,3,8564,0
1700,8564,0,8564,3,8567,0
1700,8567,0,8567,3,8570,0
1701,8570,0,8570,3,8573,0
1702,8573,0,8573,3,8576,0
1703,8580,0,8580,3,8583,0
1704,8581,2,8583,3,8586,1
1703,8583,3,8586,3,8589,1
1703,8586,3,8589,3,8592,1
1705,8587,5,8592,3,8595,2
1706,8590,5,8595,3,8598,2
1707,8595,3,8598,3,8601,1
1708,8598,3,8601,3,8604,1
1708,8604,0,8604,3,8607,0
1709,8606,1,8607,3,8610,1
1710,8612,0,8612,3,8615,0
1710,8615,0,8615,3,8618,0
1711,8616,2,8618,3,8621,1
1710,8618,3,8621,3,8624,1
1712,8619,5,8624,3,8627,2
1713,8622,5,8627,3,8630,2
1714,8624,6,8630,3,8633,2
1714,8633,0,8633,3,8636,0
1715,8633,3,8636,3,8639,1
1716,8639,0,8639,3,8642,0
1717,8644,0,8644,3,8647,0
1718,8647,0,8647,3,8650,0
1719,8654,0,8654,3,8657,0
1720,8664,0,8664,3,8667,0
1721,8669,0,8669,3,8672,0
1722,8670,2,8672,3,8675,1
1722,8675,0,8675,3,8678,0
1723,8676,2,8678,3,8681,1
1724,8681,0,8681,3,8684,0
1724,8684,0,8684,3,8687,0
1724,8687,0,8687,3,8690,0
1725,8692,0,8692,3,8695,0
1726,8696,0,8696,3,8699,0
1727,8703,0,8703,3,8706,0
1728,8708,0,8708,3,8711,0
1728,8711,0,8711,3,8714,0
1729,8713,1,8714,3,8717,1
1730,8717,0,8717,3,8720,0
1731,8721,0,8721,3,8724,0
1731,8724,0,8724,3,8727,0
1732,8726,1,8727,3,8730,1
1732,8730,0,8730,3,8733,0
1733,8733,0,8733,3,8736,0
1734,8737,0,8737,3,8740,0
1735,8743,0,8743,3,8746,0
1736,8747,0,8747,3,8750,0
1737,8754,0,8754,3,8757,0
1738,8762,0,8762,3,8765,0
1739,8769,0,8769,3,8772,0
1740,8772,0,8772,3,8775,0
1740,8775,0,8775,3,8778,0
1741,8776,2,8778,3,8781,1
1742,8782,0,8782,3,8785,0
1743,8784,1,8785,3,8788,1
1744,8794,0,8794,3,8797,0
1744,8797,0,8797,3,8800,0
1745,8800,0,8800,3,8803,0
1746,8806,0,8806,3,8809,0
1746,8809,0,8809,3,8812,0
1747,8812,0,8812,3,8815,0
1748,8814,1,8815,3,8818,1
1749,8819,0,8819,3,8822,0
1750,8825,0,8825,3,8828,0
1750,8828,0,8828,3,8831,0
1751,8829,2,8831,3,8834,1
1752,8837,0,8837,3,8840,0
1753,8843,0,8843,3,8846,0
1754,8850,0,8850,3,8853,0
1755,8861,0,8861,3,8864,0
1755,8864,0,8864,3,8867,0
1756,8869,0,8869,3,8872,0
1757,8873,0,8873,3,8876,0
1758,8877,0,8877,3,8880,0
1758,8880,0,8880,3,8883,0
1759,8881,2,8883,3,8886,1
1760,8886,0,8886,3,8889,0
1761,8891,0,8891,3,8894,0
1762,8900,0,8900,3,8903,0
1763,8904,0,8904,3,8907,0
1764,8905,2,8907,3,8910,1
1765,8910,0,8910,3,8913,0
1766,8915,0,8915,3,8918,0
1766,8918,0,8918,3,8921,0
1767,8919,2,8921,3,8924,1
1767,8924,0,8924,3,8927,0
1768,8924,3,8927,3,8930,1
1769,8931,0,8931,3,8934,0
1770,8939,0,8939,3,8942,0
1770,8942,0,8942,3,8945,0
1771,8943,2,8945,3,8948,1
1772,8946,2,8948,3,8951,1
1771,8948,3,8951,3,8954,1
1773,8953,1,8954,3,8957,1
1773,8957,0,8957,3,8960,0
1774,8958,2,8960,3,8963,1
1775,8960,3,8963,3,8966,1
1774,8963,3,8966,3,8969,1
1776,8964,5,8969,3,8972,2
1774,8966,6,8972,3,8975,2
1774,8969,6,8975,3,8978,2
1777,8974,4,8978,3,8981,2
1776,8978,3,8981,3,8984,1
1778,8980,4,8984,3,8987,2
1779,8983,4,8987,3,8990,2
1780,8994,0,8994,3,8997,0
1780,8997,0,8997,3,9000,0
1781,8999,1,9000,3,9003,1
1780,9000,3,9003,3,9006,1
1781,9006,0,9006,3,9009,0
1782,9009,0,9009,3,9012,0
1783,9016,0,9016,3,9019,0
1784,9018,1,9019,3,9022,1
1785,9023,0,9023,3,9026,0
1785,9026,0,9026,3,9029,0
1786,9030,0,9030,3,9033,0
1787,9033,0,9033,3,9036,0
1787,9036,0,9036,3,9039,0
1788,9041,0,9041,3,9044,0
1789,9045,0,9045,3,9048,0
1790,9049,0,9049,3,9052,0
1791,9058,0,9058,3,9061,0
1792,9063,0,9063,3,9066,0
1793,9070,0,9070,3,9073,0
1794,9072,1,9073,3,9076,1
1793,9073,3,9076,3,9079,1
1795,9076,3,9079,3,9082,1
1796,9081,1,9082,3,9085,1
1796,9085,0,9085,3,9088,0
1797,9086,2,9088,3,9091,1
1798,9090,1,9091,3,9094,1
1799,9098,0,9098,3,9101,0
1800,9102,0,9102,3,9105,0
1801,9107,0,9107,3,9110,0
1801,9110,0,9110,3,9113,0
1802,9110,3,9113,3,9116,1
1801,9113,3,9116,3,9119,1
1803,9114,5,9119,3,9122,2
1804,9121,1,9122,3,9125,1
1805,9127,0,9127,3,9130,0
1806,9131,0,9131,3,9134,0
1806,9134,0,9134,3,9137,0
1807,9135,2,9137,3,9140,1
1806,9137,3,9140,3,9143,1
1808,9139,4,9143,3,9146,2
1809,9143,3,9146,3,9149,1
1809,9149,0,9149,3,9152,0
1810,9149,3,9152,3,9155,1
1811,9154,1,9155,3,9158,1
1812,9158,0,9158,3,9161,0
1813,9167,0,9167,3,9170,0
1813,9170,0,9170,3,9173,0
1814,9172,1,9173,3,9176,1
1814,9176,0,9176,3,9179,0
1815,9177,2,9179,3,9182,1
1816,9182,0,9182,3,9185,0
1817,9187,0,9187,3,9190,0
1818,9188,2,9190,3,9193,1
1817,9190,3,9193,3,9196,1
1817,9193,3,9196,3,9199,1
1819,9193,6,9199,3,9202,2
1817,9196,6,9202,3,9205,2
1820,9202,3,9205,3,9208,1
1819,9205,3,9208,3,9211,1
1821,9213,0,9213,3,9216,0
1822,9221,0,9221,3,9224,0
1823,9225,0,9225,3,9228,0
1824,9226,2,9228,3,9231,1
1825,9230,1,9231,3,9234,1
1826,9233,1,9234,3,9237,1
1825,9234,3,9237,3,9240,1
1827,9235,5,9240,3,9243,2
1827,9243,0,9243,3,9246,0
1828,9244,2,9246,3,9249,1
1829,9247,2,9249,3,9252,1
1830,9251,1,9252,3,9255,1
1830,9255,0,9255,3,9258,0
1831,9258,0,9258,3,9261,0
1832,9265,0,9265,3,9268,0
1833,9268,0,9268,3,9271,0
1834,9273,0,9273,3,9276,0
1835,9281,0,9281,3,9284,0
1835,9284,0,9284,3,9287,0
1836,9287,0,9287,3,9290,0
1836,9290,0,9290,3,9293,0
1837,9290,3,9293,3,9296,1
1838,9294,2,9296,3,9299,1
1839,9297,2,9299,3,9302,1
1840,9303,0,9303,3,9306,0
1840,9306,0,9306,3,9309,0
1841,9306,3,9309,3,9312,1
1840,9309,3,9312,3,9315,1
1842,9313,2,9315,3,9318,1
1843,9315,3,9318,3,9321,1
1844,9318,3,9321,3,9324,1
1843,9321,3,9324,3,9327,1
1845,9323,4,9327,3,9330,2
1843,9324,6,9330,3,9333,2
1846,9327,6,9333,3,9336,2
1844,9330,6,9336,3,9339,2
1847,9333,6,9339,3,9342,2
1845,9336,6,9342,3,9345,2
1848,9338,7,9345,3,9348,3
1847,9345,3,9348,3,9351,1
1849,9346,5,9351,3,9354,2
1850,9352,2,9354,3,9357,1
1851,9355,2,9357,3,9360,1
1851,9360,0,9360,3,9363,0
1852,9360,3,9363,3,9366,1
1851,9363,3,9366,3,9369,1
1853,9365,4,9369,3,9372,2
1851,9366,6,9372,3,9375,2
1851,9369,6,9375,3,9378,2
1854,9369,9,9378,3,9381,3
1851,9372,9,9381,3,9384,3
1855,9372,12,9384,3,9387,4
1852,9378,9,9387,3,9390,3
1856,9381,9,9390,3,9393,3
1853,9384,9,9393,3,9396,3
1857,9389,7,9396,3,9399,3
1855,9393,6,9399,3,9402,2
1858,9394,8,9402,3,9405,3
1855,9396,9,9405,3,9408,3
1855,9399,9,9408,3,9411,3
1859,9399,12,9411,3,9414,4
1855,9402,12,9414,3,9417,4
1860,9404,13,9417,3,9420,5
1861,9414,6,9420,3,9423,2
1859,9417,6,9423,3,9426,2
1860,9423,3,9426,3,9429,1
1862,9426,3,9429,3,9432,1
1863,9427,5,9432,3,9435,2
1862,9432,3,9435,3,9438,1
1864,9434,4,9438,3,9441,2
1863,9438,3,9441,3,9444,1
1865,9440,4,9444,3,9447,2
1863,9441,6,9447,3,9450,2
1866,9443,7,9450,3,9453,3
1867,9446,7,9453,3,9456,3
1864,9447,9,9456,3,9459,3
1868,9452,7,9459,3,9462,3
1869,9453,9,9462,3,9465,3
1867,9459,6,9465,3,9468,2
1870,9460,8,9468,3,9471,3
1871,9468,3,9471,3,9474,1
1870,9471,3,9474,3,9477,1
1870,9474,3,9477,3,9480,1
1872,9474,6,9480,3,9483,2
1873,9479,4,9483,3,9486,2
1871,9480,6,9486,3,9489,2
1872,9486,3,9489,3,9492,1
1874,9487,5,9492,3,9495,2
1875,9489,6,9495,3,9498,2
1876,9491,7,9498,3,9501,3
1873,9492,9,9501,3,9504,3
1877,9495,9,9504,3,9507,3
1878,9497,10,9507,3,9510,4
1874,9498,12,9510,3,9513,4
1874,9501,12,9513,3,9516,4
1879,9503,13,9516,3,9519,5
1874,9504,15,9519,3,9522,5
1880,9508,14,9522,3,9525,5
1875,9510,15,9525,3,9528,5
1881,9511,17,9528,3,9531,6
1877,9519,12,9531,3,9534,4
1882,9522,12,9534,3,9537,4
1883,9525,12,9537,3,9540,4
1879,9528,12,9540,3,9543,4
1884,9532,11,9543,3,9546,4
1881,9537,9,9546,3,9549,3
1885,9537,12,9549,3,9552,4
1886,9544,8,9552,3,9555,3
1887,9549,6,9555,3,9558,2
1888,9554,4,9558,3,9561,2
1889,9559,2,9561,3,9564,1
1889,9564,0,9564,3,9567,0
1890,9564,3,9567,3,9570,1
1891,9569,1,9570,3,9573,1
1892,9571,2,9573,3,9576,1
1893,9579,0,9579,3,9582,0
1894,9583,0,9583,3,9586,0
1894,9586,0,9586,3,9589,0
1895,9591,0,9591,3,9594,0
1896,9596,0,9596,3,9599,0
1897,9600,0,9600,3,9603,0
1898,9605,0,9605,3,9608,0
1899,9608,0,9608,3,9611,0
1900,9610,1,9611,3,9614,1
1899,9611,3,9614,3,9617,1
1900,9617,0,9617,3,9620,0
1901,9617,3,9620,3,9623,1
1902,9620,3,9623,3,9626,1
1903,9625,1,9626,3,9629,1
1904,9626,3,9629,3,9632,1
1905,9630,2,9632,3,9635,1
1906,9640,0,9640,3,9643,0
1906,9643,0,9643,3,9646,0
1907,9649,0,9649,3,9652,0
1908,9651,1,9652,3,9655,1
1908,9655,0,9655,3,9658,0
1909,9663,0,9663,3,9666,0
1910,9668,0,9668,3,9671,0
1911,9672,0,9672,3,9675,0
1911,9675,0,9675,3,9678,0
1912,9677,1,9678,3,9681,1
1911,9678,3,9681,3,9684,1
1912,9684,0,9684,3,9687,0
1913,9686,1,9687,3,9690,1
1913,9690,0,9690,3,9693,0
1913,9693,0,9693,3,9696,0
1914,9693,3,9696,3,9699,1
1915,9697,2,9699,3,9702,1
1916,9702,0,9702,3,9705,0
1917,9708,0,9708,3,9711,0
1918,9711,0,9711,3,9714,0
1919,9715,0,9715,3,9718,0
1920,9718,0,9718,3,9721,0
1921,9720,1,9721,3,9724,1
1920,9721,3,9724,3,9727,1
1920,9724,3,9727,3,9730,1
1922,9728,2,9730,3,9733,1
1923,9729,4,9733,3,9736,2
1924,9739,0,9739,3,9742,0
1925,9744,0,9744,3,9747,0
1925,9747,0,9747,3,9750,0
1926,9747,3,9750,3,9753,1
1925,9750,3,9753,3,9756,1
1927,9755,1,9756,3,9759,1
1928,9759,0,9759,3,9762,0
1929,9765,0,9765,3,9768,0
1930,9769,0,9769,3,9772,0
1931,9775,0,9775,3,9778,0
1932,9785,0,9785,3,9788,0
1933,9788,0,9788,3,9791,0
1934,9792,0,9792,3,9795,0
1935,9798,0,9798,3,9801,0
1935,9801,0,9801,3,9804,0
1935,9804,0,9804,3,9807,0
1935,9807,0,9807,3,9810,0
1936,9807,3,9810,3,9813,1
1937,9811,2,9813,3,9816,1
1938,9819,0,9819,3,9822,0
1938,9822,0,9822,3,9825,0
1939,9827,0,9827,3,9830,0
1940,9834,0,9834,3,9837,0
1940,9837,0,9837,3,9840,0
1941,9839,1,9840,3,9843,1
1942,9842,1,9843,3,9846,1
1942,9846,0,9846,3,9849,0
1943,9846,3,9849,3,9852,1
1942,9849,3,9852,3,9855,1
1944,9852,3,9855,3,9858,1
1945,9857,1,9858,3,9861,1
1946,9861,0,9861,3,9864,0
1947,9871,0,9871,3,9874,0
1948,9874,0,9874,3,9877,0
1949,9880,0,9880,3,9883,0
1950,9888,0,9888,3,9891,0
1950,9891,0,9891,3,9894,0
1951,9891,3,9894,3,9897,1
1952,9895,2,9897,3,9900,1
1951,9897,3,9900,3,9903,1
1953,9899,4,9903,3,9906,2
1954,9900,6,9906,3,9909,2
1955,9908,1,9909,3,9912,1
1956,9911,1,9912,3,9915,1
1955,9912,3,9915,3,9918,1
1955,9915,3,9918,3,9921,1
1957,9920,1,9921,3,9924,1
1958,9923,1,9924,3,9927,1
1959,9926,1,9927,3,9930,1
1960,9929,1,9930,3,9933,1
1960,9933,0,9933,3,9936,0
1960,9936,0,9936,3,9939,0
1961,9936,3,9939,3,9942,1
1960,9939,3,9942,3,9945,1
1962,9941,4,9945,3,9948,2
1963,9946,2,9948,3,9951,1
1964,9950,1,9951,3,9954,1
1965,9954,0,9954,3,9957,0
1966,9960,0,9960,3,9963,0
1966,9963,0,9963,3,9966,0
1967,9964,2,9966,3,9969,1
1966,9966,3,9969,3,9972,1
1968,9968,4,9972,3,9975,2
1969,9976,0,9976,3,9979,0
1970,9981,0,9981,3,9984,0
1971,9985,0,9985,3,9988,0
1971,9988,0,9988,3,9991,0
1972,9990,1,9991,3,9994,1
1973,9996,0,9996,3,9999,0
1974,10001,0,10001,3,10004,0
1975,10003,1,10004,3,10007,1
1975,10007,0,10007,3,10010,0
1976,10008,2,10010,3,10013,1
1977,10013,0,10013,3,10016,0
1978,10017,0,10017,3,10020,0
1979,10019,1,10020,3,10023,1
1978,10020,3,10023,3,10026,1
1978,10023,3,10026,3,10029,1
1980,10024,5,10029,3,10032,2
1978,10026,6,10032,3,10035,2
1978,10029,6,10035,3,10038,2
1981,10029,9,10038,3,10041,3
1982,10033,8,10041,3,10044,3
1983,10037,7,10044,3,10047,3
1980,10038,9,10047,3,10050,3
1980,10041,9,10050,3,10053,3
1980,10044,9,10053,3,10056,3
1984,10046,10,10056,3,10059,4
1985,10050,9,10059,3,10062,3
1986,10050,12,10062,3,10065,4
1987,10053,12,10065,3,10068,4
1988,10054,14,10068,3,10071,5
1989,10058,13,10071,3,10074,5
1984,10059,15,10074,3,10077,5
1990,10065,12,10077,3,10080,4
1986,10068,12,10080,3,10083,4
1991,10069,14,10083,3,10086,5
1987,10074,12,10086,3,10089,4
1992,10074,15,10089,3,10092,5
1993,10079,13,10092,3,10095,5
1994,10083,12,10095,3,10098,4
1995,10085,13,10098,3,10101,5
1990,10086,15,10101,3,10104,5
1991,10092,12,10104,3,10107,4
1996,10092,15,10107,3,10110,5
1992,10098,12,10110,3,10113,4
1992,10101,12,10113,3,10116,4
1997,10103,13,10116,3,10119,5
1992,10104,15,10119,3,10122,5
1998,10107,15,10122,3,10125,5
1994,10113,12,10125,3,10128,4
1999,10116,12,10128,3,10131,4
1995,10119,12,10131,3,10134,4
2000,10122,12,10134,3,10137,4
1997,10128,9,10137,3,10140,3
2001,10129,11,10140,3,10143,4
2002,10134,9,10143,3,10146,3
2003,10138,8,10146,3,10149,3
2000,10140,9,10149,3,10152,3
2004,10146,6,10152,3,10155,2
2005,10151,4,10155,3,10158,2
2006,10153,5,10158,3,10161,2
2007,10156,5,10161,3,10164,2
2008,10157,7,10164,3,10167,3
2009,10158,9,10167,3,10170,3
2010,10160,10,10170,3,10173,4
2011,10161,12,10173,3,10176,4
2007,10164,12,10176,3,10179,4
2007,10167,12,10179,3,10182,4
2012,10167,15,10182,3,10185,5
2013,10171,14,10185,3,10188,5
2008,10173,15,10188,3,10191,5
2014,10174,17,10191,3,10194,6
2015,10177,17,10194,3,10197,6
2016,10180,17,10197,3,10200,6
2017,10187,13,10200,3,10203,5
2012,10188,15,10203,3,10206,5
2018,10191,15,10206,3,10209,5
2019,10195,14,10209,3,10212,5
2015,10200,12,10212,3,10215,4
2020,10200,15,10215,3,10218,5
2021,10210,8,10218,3,10221,3
2019,10215,6,10221,3,10224,2
2022,10215,9,10224,3,10227,3
2023,10219,8,10227,3,10230,3
2024,10221,9,10230,3,10233,3
2025,10222,11,10233,3,10236,4
2021,10224,12,10236,3,10239,4
2026,10225,14,10239,3,10242,5
2022,10230,12,10242,3,10245,4
2027,10231,14,10245,3,10248,5
2028,10234,14,10248,3,10251,5
2023,10236,15,10251,3,10254,5
2029,10237,17,10254,3,10257,6
2024,10242,15,10257,3,10260,5
2030,10242,18,10260,3,10263,6
2031,10248,15,10263,3,10266,5
2032,10253,13,10266,3,10269,5
2027,10254,15,10269,3,10272,5
2033,10260,12,10272,3,10275,4
2034,10265,10,10275,3,10278,4
2031,10269,9,10278,3,10281,3
2035,10270,11,10281,3,10284,4
2036,10273,11,10284,3,10287,4
2034,10281,6,10287,3,10290,2
2037,10281,9,10290,3,10293,3
2038,10286,7,10293,3,10296,3
2039,10288,8,10296,3,10299,3
2040,10296,3,10299,3,10302,1
2039,10299,3,10302,3,10305,1
2041,10305,0,10305,3,10308,0
2041,10308,0,10308,3,10311,0
2042,10312,0,10312,3,10315,0
2042,10315,0,10315,3,10318,0
2042,10318,0,10318,3,10321,0
2043,10319,2,10321,3,10324,1
2044,10322,2,10324,3,10327,1
2043,10324,3,10327,3,10330,1
2045,10324,6,10330,3,10333,2
2046,10328,5,10333,3,10336,2
2045,10333,3,10336,3,10339,1
2047,10335,4,10339,3,10342,2
2048,10337,5,10342,3,10345,2
2049,10344,1,10345,3,10348,1
2050,10351,0,10351,3,10354,0
2051,10358,0,10358,3,10361,0
2052,10361,0,10361,3,10364,0
2053,10365,0,10365,3,10368,0
2054,10369,0,10369,3,10372,0
2055,10374,0,10374,3,10377,0
2056,10375,2,10377,3,10380,1
2057,10378,2,10380,3,10383,1
2058,10381,2,10383,3,10386,1
2059,10388,0,10388,3,10391,0
2059,10391,0,10391,3,10394,0
2060,10391,3,10394,3,10397,1
2060,10397,0,10397,3,10400,0
2061,10398,2,10400,3,10403,1
2062,10399,4,10403,3,10406,2
2063,10406,0,10406,3,10409,0
2064,10410,0,10410,3,10413,0
2064,10413,0,10413,3,10416,0
2064,10416,0,10416,3,10419,0
2065,10417,2,10419,3,10422,1
2066,10423,0,10423,3,10426,0
2067,10425,1,10426,3,10429,1
2068,10428,1,10429,3,10432,1
2069,10435,0,10435,3,10438,0
2070,10436,2,10438,3,10441,1
2071,10445,0,10445,3,10448,0
2071,10448,0,10448,3,10451,0
2071,10451,0,10451,3,10454,0
2072,10457,0,10457,3,10460,0
2073,10464,0,10464,3,10467,0
2074,10471,0,10471,3,10474,0
2075,10481,0,10481,3,10484,0
2076,10486,0,10486,3,10489,0
2077,10490,0,10490,3,10493,0
2077,10493,0,10493,3,10496,0
2078,10498,0,10498,3,10501,0
2078,10501,0,10501,3,10504,0
2079,10504,0,10504,3,10507,0
2080,10508,0,10508,3,10511,0
2081,10514,0,10514,3,10517,0
2081,10517,0,10517,3,10520,0
2082,10519,1,10520,3,10523,1
2083,10525,0,10525,3,10528,0
2084,10535,0,10535,3,10538,0
2085,10537,1,10538,3,10541,1
2086,10540,1,10541,3,10544,1
2086,10544,0,10544,3,10547,0
2087,10546,1,10547,3,10550,1
2086,10547,3,10550,3,10553,1
2088,10558,0,10558,3,10561,0
2088,10561,0,10561,3,10564,0
2089,10564,0,10564,3,10567,0
2090,10569,0,10569,3,10572,0
2091,10572,0,10572,3,10575,0
2092,10579,0,10579,3,10582,0
2093,10588,0,10588,3,10591,0
2093,10591,0,10591,3,10594,0
2094,10592,2,10594,3,10597,1
2095,10602,0,10602,3,10605,0
2096,10605,0,10605,3,10608,0
2096,10608,0,10608,3,10611,0
2097,10611,0,10611,3,10614,0
2098,10614,0,10614,3,10617,0
2099,10620,0,10620,3,10623,0
2100,10624,0,10624,3,10627,0
2101,10628,0,10628,3,10631,0
2101,10631,0,10631,3,10634,0
2102,10632,2,10634,3,10637,1
2101,10634,3,10637,3,10640,1
2103,10636,4,10640,3,10643,2
2102,10640,3,10643,3,10646,1
2104,10642,4,10646,3,10649,2
2105,10645,4,10649,3,10652,2
2103,10646,6,10652,3,10655,2
2106,10649,6,10655,3,10658,2
2104,10652,6,10658,3,10661,2
2107,10652,9,10661,3,10664,3
2108,10654,10,10664,3,10667,4
2109,10657,10,10667,3,10670,4
2110,10659,11,10670,3,10673,4
2106,10661,12,10673,3,10676,4
2111,10663,13,10676,3,10679,5
2106,10664,15,10679,3,10682,5
2112,10666,16,10682,3,10685,6
2107,10670,15,10685,3,10688,5
2113,10673,15,10688,3,10691,5
2114,10680,11,10691,3,10694,4
2115,10682,12,10694,3,10697,4
2116,10688,9,10697,3,10700,3
2117,10693,7,10700,3,10703,3
2115,10697,6,10703,3,10706,2
2118,10700,6,10706,3,10709,2
2119,10705,4,10709,3,10712,2
2120,10709,3,10712,3,10715,1
2121,10715,0,10715,3,10718,0
2122,10719,0,10719,3,10722,0
2122,10722,0,10722,3,10725,0
2123,10727,0,10727,3,10730,0
2124,10732,0,10732,3,10735,0
2125,10740,0,10740,3,10743,0
2125,10743,0,10743,3,10746,0
2126,10746,0,10746,3,10749,0
2127,10750,0,10750,3,10753,0
2128,10752,1,10753,3,10756,1
2127,10753,3,10756,3,10759,1
2129,10756,3,10759,3,10762,1
2129,10762,0,10762,3,10765,0
2130,10764,1,10765,3,10768,1
2129,10765,3,10768,3,10771,1
2131,10768,3,10771,3,10774,1
2132,10770,4,10774,3,10777,2
2130,10771,6,10777,3,10780,2
2133,10773,7,10780,3,10783,3
2134,10778,5,10783,3,10786,2
2135,10785,1,10786,3,10789,1
2136,10787,2,10789,3,10792,1
2136,10792,0,10792,3,10795,0
2137,10794,1,10795,3,10798,1
2138,10800,0,10800,3,10803,0
2139,10803,0,10803,3,10806,0
2140,10805,1,10806,3,10809,1
2141,10812,0,10812,3,10815,0
2142,10819,0,10819,3,10822,0
2143,10828,0,10828,3,10831,0
2144,10830,1,10831,3,10834,1
2144,10834,0,10834,3,10837,0
2145,10835,2,10837,3,10840,1
2144,10837,3,10840,3,10843,1
2146,10842,1,10843,3,10846,1
2146,10846,0,10846,3,10849,0
2147,10850,0,10850,3,10853,0
2148,10856,0,10856,3,10859,0
2149,10861,0,10861,3,10864,0
2150,10868,0,10868,3,10871,0
2151,10875,0,10875,3,10878,0
2152,10877,1,10878,3,10881,1
2151,10878,3,10881,3,10884,1
2151,10881,3,10884,3,10887,1
2153,10881,6,10887,3,10890,2
2154,10883,7,10890,3,10893,3
2155,10888,5,10893,3,10896,2
2154,10893,3,10896,3,10899,1
2156,10894,5,10899,3,10902,2
2157,10899,3,10902,3,10905,1
2158,10904,1,10905,3,10908,1
2159,10908,0,10908,3,10911,0
2160,10914,0,10914,3,10917,0
2160,10917,0,10917,3,10920,0
2161,10917,3,10920,3,10923,1
2160,10920,3,10923,3,10926,1
2160,10923,3,10926,3,10929,1
2162,10927,2,10929,3,10932,1
2163,10930,2,10932,3,10935,1
2164,10935,0,10935,3,10938,0
2165,10939,0,10939,3,10942,0
2165,10942,0,10942,3,10945,0
2166,10944,1,10945,3,10948,1
2167,10951,0,10951,3,10954,0
2167,10954,0,10954,3,10957,0
2168,10954,3,10957,3,10960,1
2167,10957,3,10960,3,10963,1
2169,10959,4,10963,3,10966,2
2170,10964,2,10966,3,10969,1
2169,10966,3,10969,3,10972,1
2171,10967,5,10972,3,10975,2
2170,10972,3,10975,3,10978,1
2172,10972,6,10978,3,10981,2
2173,10977,4,10981,3,10984,2
2171,10978,6,10984,3,10987,2
2174,10982,5,10987,3,10990,2
2173,10987,3,10990,3,10993,1
2175,10987,6,10993,3,10996,2
2176,10996,0,10996,3,10999,0
2177,10998,1,10999,3,11002,1
2178,11001,1,11002,3,11005,1
2178,11005,0,11005,3,11008,0
2179,11005,3,11008,3,11011,1
2178,11008,3,11011,3,11014,1
2180,11008,6,11014,3,11017,2
2181,11015,2,11017,3,11020,1
2180,11017,3,11020,3,11023,1
2182,11019,4,11023,3,11026,2
2182,11026,0,11026,3,11029,0
2183,11026,3,11029,3,11032,1
2184,11029,3,11032,3,11035,1
2185,11032,3,11035,3,11038,1
2186,11039,0,11039,3,11042,0
2187,11046,0,11046,3,11049,0
2188,11052,0,11052,3,11055,0
2188,11055,0,11055,3,11058,0
2189,11055,3,11058,3,11061,1
2190,11058,3,11061,3,11064,1
2189,11061,3,11064,3,11067,1
2191,11061,6,11067,3,11070,2
2192,11062,8,11070,3,11073,3
2193,11066,7,11073,3,11076,3
2190,11067,9,11076,3,11079,3
2190,11070,9,11079,3,11082,3
2194,11076,6,11082,3,11085,2
2195,11080,5,11085,3,11088,2
2196,11085,3,11088,3,11091,1
2196,11091,0,11091,3,11094,0
2197,11093,1,11094,3,11097,1
2198,11098,0,11098,3,11101,0
2199,11102,0,11102,3,11105,0
2199,11105,0,11105,3,11108,0
2200,11107,1,11108,3,11111,1
2200,11111,0,11111,3,11114,0
2201,11114,0,11114,3,11117,0
2202,11118,0,11118,3,11121,0
2203,11125,0,11125,3,11128,0
2203,11128,0,11128,3,11131,0
2204,11130,1,11131,3,11134,1
2205,11133,1,11134,3,11137,1
2206,11135,2,11137,3,11140,1
2207,11139,1,11140,3,11143,1
2208,11143,0,11143,3,11146,0
2209,11148,0,11148,3,11151,0
2210,11156,0,11156,3,11159,0
2211,11160,0,11160,3,11163,0
2212,11163,0,11163,3,11166,0
2213,11167,0,11167,3,11170,0
2214,11171,0,11171,3,11174,0
2215,11174,0,11174,3,11177,0
2216,11179,0,11179,3,11182,0
2216,11182,0,11182,3,11185,0
2217,11187,0,11187,3,11190,0
2218,11191,0,11191,3,11194,0
2218,11194,0,11194,3,11197,0
2219,11200,0,11200,3,11203,0
2219,11203,0,11203,3,11206,0
2220,11203,3,11206,3,11209,1
2221,11210,0,11210,3,11213,0
2222,11214,0,11214,3,11217,0
2223,11216,1,11217,3,11220,1
2222,11217,3,11220,3,11223,1
2222,11220,3,11223,3,11226,1
2224,11220,6,11226,3,11229,2
2225,11224,5,11229,3,11232,2
2224,11229,3,11232,3,11235,1
2226,11229,6,11235,3,11238,2
2224,11232,6,11238,3,11241,2
2227,11236,5,11241,3,11244,2
2225,11238,6,11244,3,11247,2
2228,11243,4,11247,3,11250,2
2227,11247,3,11250,3,11253,1
2229,11250,3,11253,3,11256,1
2230,11253,3,11256,3,11259,1
2231,11257,2,11259,3,11262,1
2232,11262,0,11262,3,11265,0
2232,11265,0,11265,3,11268,0
2232,11268,0,11268,3,11271,0
2232,11271,0,11271,3,11274,0
2233,11271,3,11274,3,11277,1
2234,11274,3,11277,3,11280,1
2233,11277,3,11280,3,11283,1
2235,11279,4,11283,3,11286,2
2236,11284,2,11286,3,11289,1
2237,11287,2,11289,3,11292,1
2238,11292,0,11292,3,11295,0
2238,11295,0,11295,3,11298,0
2238,11298,0,11298,3,11301,0
2239,11298,3,11301,3,11304,1
2238,11301,3,11304,3,11307,1
2238,11304,3,11307,3,11310,1
2240,11304,6,11310,3,11313,2
2241,11310,3,11313,3,11316,1
2242,11314,2,11316,3,11319,1
2243,11322,0,11322,3,11325,0
2244,11329,0,11329,3,11332,0
2245,11331,1,11332,3,11335,1
2246,11335,0,11335,3,11338,0
2247,11337,1,11338,3,11341,1
2246,11338,3,11341,3,11344,1
2248,11339,5,11344,3,11347,2
2247,11344,3,11347,3,11350,1
2249,11344,6,11350,3,11353,2
2250,11349,4,11353,3,11356,2
2251,11353,3,11356,3,11359,1
2250,11356,3,11359,3,11362,1
2252,11357,5,11362,3,11365,2
2251,11362,3,11365,3,11368,1
2253,11365,3,11368,3,11371,1
2254,11370,1,11371,3,11374,1
2255,11376,0,11376,3,11379,0
2256,11380,0,11380,3,11383,0
2256,11383,0,11383,3,11386,0
2257,11386,0,11386,3,11389,0
2258,11392,0,11392,3,11395,0
2258,11395,0,11395,3,11398,0
2259,11398,0,11398,3,11401,0
2260,11408,0,11408,3,11411,0
2261,11411,0,11411,3,11414,0
2261,11414,0,11414,3,11417,0
2262,11417,0,11417,3,11420,0
2263,11423,0,11423,3,11426,0
2264,11429,0,11429,3,11432,0
2265,11432,0,11432,3,11435,0
2266,11441,0,11441,3,11444,0
2266,11444,0,11444,3,11447,0
2267,11445,2,11447,3,11450,1
2268,11446,4,11450,3,11453,2
2267,11450,3,11453,3,11456,1
2269,11451,5,11456,3,11459,2
2270,11455,4,11459,3,11462,2
2268,11456,6,11462,3,11465,2
2271,11459,6,11465,3,11468,2
2272,11464,4,11468,3,11471,2
2273,11471,0,11471,3,11474,0
2274,11477,0,11477,3,11480,0
2275,11487,0,11487,3,11490,0
2275,11490,0,11490,3,11493,0
2276,11492,1,11493,3,11496,1
2277,11493,3,11496,3,11499,1
2277,11499,0,11499,3,11502,0
2278,11502,0,11502,3,11505,0
2279,11507,0,11507,3,11510,0
2280,11513,0,11513,3,11516,0
2281,11519,0,11519,3,11522,0
2282,11524,0,11524,3,11527,0
2283,11527,0,11527,3,11530,0
2283,11530,0,11530,3,11533,0
2284,11532,1,11533,3,11536,1
2285,11535,1,11536,3,11539,1
2284,11536,3,11539,3,11542,1
2284,11539,3,11542,3,11545,1
2286,11540,5,11545,3,11548,2
2287,11542,6,11548,3,11551,2
2286,11548,3,11551,3,11554,1
2288,11550,4,11554,3,11557,2
2289,11553,4,11557,3,11560,2
2287,11554,6,11560,3,11563,2
2290,11555,8,11563,3,11566,3
2291,11560,6,11566,3,11569,2
2292,11565,4,11569,3,11572,2
2293,11567,5,11572,3,11575,2
2291,11569,6,11575,3,11578,2
2294,11570,8,11578,3,11581,3
2295,11574,7,11581,3,11584,3
2292,11575,9,11584,3,11587,3
2296,11579,8,11587,3,11590,3
2293,11581,9,11590,3,11593,3
2297,11587,6,11593,3,11596,2
2297,11596,0,11596,3,11599,0
2298,11596,3,11599,3,11602,1
2297,11599,3,11602,3,11605,1
2299,11599,6,11605,3,11608,2
2300,11602,6,11608,3,11611,2
2301,11605,6,11611,3,11614,2
2299,11608,6,11614,3,11617,2
2302,11612,5,11617,3,11620,2
2303,11618,2,11620,3,11623,1
2304,11622,1,11623,3,11626,1
2305,11627,0,11627,3,11630,0
2306,11635,0,11635,3,11638,0
2307,11639,0,11639,3,11642,0
2308,11643,0,11643,3,11646,0
2309,11644,2,11646,3,11649,1
2310,11650,0,11650,3,11653,0
2311,11652,1,11653,3,11656,1
2312,11652,4,11656,3,11659,2
2313,11654,5,11659,3,11662,2
2314,11657,5,11662,3,11665,2
2315,11660,5,11665,3,11668,2
2316,11664,4,11668,3,11671,2
2314,11665,6,11671,3,11674,2
2314,11668,6,11674,3,11677,2
2317,11671,6,11677,3,11680,2
2315,11674,6,11680,3,11683,2
2318,11675,8,11683,3,11686,3
2315,11677,9,11686,3,11689,3
2319,11679,10,11689,3,11692,4
2315,11680,12,11692,3,11695,4
2320,11684,11,11695,3,11698,4
2321,11686,12,11698,3,11701,4
2322,11691,10,11701,3,11704,4
2318,11692,12,11704,3,11707,4
2318,11695,12,11707,3,11710,4
2323,11699,11,11710,3,11713,4
2324,11706,7,11713,3,11716,3
2325,11711,5,11716,3,11719,2
2326,11713,6,11719,3,11722,2
2327,11716,6,11722,3,11725,2
2325,11719,6,11725,3,11728,2
2328,11721,7,11728,3,11731,3
2329,11727,4,11731,3,11734,2
2330,11731,3,11734,3,11737,1
2331,11734,3,11737,3,11740,1
2332,11739,1,11740,3,11743,1
2331,11740,3,11743,3,11746,1
2331,11743,3,11746,3,11749,1
2333,11748,1,11749,3,11752,1
2332,11749,3,11752,3,11755,1
2334,11749,6,11755,3,11758,2
2332,11752,6,11758,3,11761,2
2332,11755,6,11761,3,11764,2
2335,11759,5,11764,3,11767,2
2336,11761,6,11767,3,11770,2
2337,11766,4,11770,3,11773,2
2335,11767,6,11773,3,11776,2
2338,11774,2,11776,3,11779,1
2339,11781,0,11781,3,11784,0
2340,11785,0,11785,3,11788,0
2341,11790,0,11790,3,11793,0
2341,11793,0,11793,3,11796,0
2342,11794,2,11796,3,11799,1
2343,11801,0,11801,3,11804,0
2343,11804,0,11804,3,11807,0
2344,11804,3,11807,3,11810,1
2343,11807,3,11810,3,11813,1
2345,11810,3,11813,3,11816,1
2344,11813,3,11816,3,11819,1
2344,11816,3,11819,3,11822,1
2346,11818,4,11822,3,11825,2
2347,11824,1,11825,3,11828,1
2348,11828,0,11828,3,11831,0
2349,11830,1,11831,3,11834,1
2350,11836,0,11836,3,11839,0
2351,11844,0,11844,3,11847,0
2352,11851,0,11851,3,11854,0
2353,11858,0,11858,3,11861,0
2353,11861,0,11861,3,11864,0
2353,11864,0,11864,3,11867,0
2354,11865,2,11867,3,11870,1
2355,11874,0,11874,3,11877,0
2355,11877,0,11877,3,11880,0
2355,11880,0,11880,3,11883,0
2355,11883,0,11883,3,11886,0
2356,11883,3,11886,3,11889,1
2355,11886,3,11889,3,11892,1
2357,11887,5,11892,3,11895,2
2357,11895,0,11895,3,11898,0
2358,11895,3,11898,3,11901,1
2359,11900,1,11901,3,11904,1
2360,11904,0,11904,3,11907,0
2361,11911,0,11911,3,11914,0
2362,11918,0,11918,3,11921,0
2363,11922,0,11922,3,11925,0
2364,11927,0,11927,3,11930,0
2365,11931,0,11931,3,11934,0
2366,11937,0,11937,3,11940,0
2366,11940,0,11940,3,11943,0
2367,11940,3,11943,3,11946,1
2368,11944,2,11946,3,11949,1
2369,11950,0,11950,3,11953,0
2369,11953,0,11953,3,11956,0
2370,11954,2,11956,3,11959,1
2369,11956,3,11959,3,11962,1
2371,11956,6,11962,3,11965,2
2372,11958,7,11965,3,11968,3
2373,11960,8,11968,3,11971,3
2374,11964,7,11971,3,11974,3
2375,11965,9,11974,3,11977,3
2376,11970,7,11977,3,11980,3
2374,11974,6,11980,3,11983,2
2377,11975,8,11983,3,11986,3
2378,11980,6,11986,3,11989,2
2377,11986,3,11989,3,11992,1
2379,11986,6,11992,3,11995,2
2377,11989,6,11995,3,11998,2
2380,11990,8,11998,3,12001,3
2381,11998,3,12001,3,12004,1
2380,12001,3,12004,3,12007,1
2382,12005,2,12007,3,12010,1
2383,12007,3,12010,3,12013,1
2384,12014,0,12014,3,12017,0
2384,12017,0,12017,3,12020,0
2384,12020,0,12020,3,12023,0
2385,12020,3,12023,3,12026,1
2386,12021,5,12026,3,12029,2
2387,12025,4,12029,3,12032,2
2388,12029,3,12032,3,12035,1
2389,12032,3,12035,3,12038,1
2388,12035,3,12038,3,12041,1
2390,12039,2,12041,3,12044,1
2391,12044,0,12044,3,12047,0
2392,12051,0,12051,3,12054,0
2393,12058,0,12058,3,12061,0
2394,12060,1,12061,3,12064,1
2395,12066,0,12066,3,12069,0
2396,12073,0,12073,3,12076,0
2397,12077,0,12077,3,12080,0
2398,12082,0,12082,3,12085,0
2398,12085,0,12085,3,12088,0
2399,12085,3,12088,3,12091,1
2400,12091,0,12091,3,12094,0
2401,12100,0,12100,3,12103,0
2402,12106,0,12106,3,12109,0
2403,12110,0,12110,3,12113,0
2404,12114,0,12114,3,12117,0
2405,12118,0,12118,3,12121,0
2405,12121,0,12121,3,12124,0
2406,12123,1,12124,3,12127,1
2406,12127,0,12127,3,12130,0
2406,12130,0,12130,3,12133,0
2406,12133,0,12133,3,12136,0
2407,12133,3,12136,3,12139,1
2408,12140,0,12140,3,12143,0
2409,12144,0,12144,3,12147,0
2409,12147,0,12147,3,12150,0
2410,12149,1,12150,3,12153,1
2409,12150,3,12153,3,12156,1
2411,12152,4,12156,3,12159,2
2409,12153,6,12159,3,12162,2
2412,12156,6,12162,3,12165,2
2413,12161,4,12165,3,12168,2
2411,12162,6,12168,3,12171,2
2414,12167,4,12171,3,12174,2
2412,12168,6,12174,3,12177,2
2415,12175,2,12177,3,12180,1
2416,12179,1,12180,3,12183,1
2416,12183,0,12183,3,12186,0
2417,12185,1,12186,3,12189,1
2416,12186,3,12189,3,12192,1
2418,12192,0,12192,3,12195,0
2418,12195,0,12195,3,12198,0
2418,12198,0,12198,3,12201,0
2419,12198,3,12201,3,12204,1
2420,12205,0,12205,3,12208,0
2421,12210,0,12210,3,12213,0
2422,12216,0,12216,3,12219,0
2422,12219,0,12219,3,12222,0
2423,12219,3,12222,3,12225,1
2424,12221,4,12225,3,12228,2
2422,12222,6,12228,3,12231,2
2425,12224,7,12231,3,12234,3
2426,12229,5,12234,3,12237,2
2427,12232,5,12237,3,12240,2
2428,12233,7,12240,3,12243,3
2425,12234,9,12243,3,12246,3
2425,12237,9,12246,3,12249,3
2429,12237,12,12249,3,12252,4
2425,12240,12,12252,3,12255,4
2426,12246,9,12255,3,12258,3
2430,12247,11,12258,3,12261,4
2426,12249,12,12261,3,12264,4
2431,12252,12,12264,3,12267,4
2432,12259,8,12267,3,12270,3
2429,12261,9,12270,3,12273,3
2433,12266,7,12273,3,12276,3
2431,12270,6,12276,3,12279,2
2434,12270,9,12279,3,12282,3
2435,12273,9,12282,3,12285,3
2436,12275,10,12285,3,12288,4
2437,12281,7,12288,3,12291,3
2438,12284,7,12291,3,12294,3
2435,12285,9,12294,3,12297,3
2439,12287,10,12297,3,12300,4
2435,12288,12,12300,3,12303,4
2435,12291,12,12303,3,12306,4
2440,12292,14,12306,3,12309,5
2441,12296,13,12309,3,12312,5
2437,12300,12,12312,3,12315,4
2442,12302,13,12315,3,12318,5
2437,12303,15,12318,3,12321,5
2443,12308,13,12321,3,12324,5
2438,12309,15,12324,3,12327,5
2444,12316,11,12327,3,12330,4
2440,12318,12,12330,3,12333,4
2440,12321,12,12333,3,12336,4
2445,12321,15,12336,3,12339,5
2446,12323,16,12339,3,12342,6
2441,12327,15,12342,3,12345,5
2447,12328,17,12345,3,12348,6
2441,12330,18,12348,3,12351,6
2441,12333,18,12351,3,12354,6
2448,12333,21,12354,3,12357,7
2442,12339,18,12357,3,12360,6
2449,12340,20,12360,3,12363,7
2450,12343,20,12363,3,12366,7
2451,12349,17,12366,3,12369,6
2446,12354,15,12369,3,12372,5
2452,12355,17,12372,3,12375,6
2453,12363,12,12375,3,12378,4
2450,12369,9,12378,3,12381,3
2454,12371,10,12381,3,12384,4
2455,12372,12,12384,3,12387,4
2451,12375,12,12387,3,12390,4
2456,12375,15,12390,3,12393,5
2457,12380,13,12393,3,12396,5
2458,12382,14,12396,3,12399,5
2459,12385,14,12399,3,12402,5
2460,12390,12,12402,3,12405,4
2461,12399,6,12405,3,12408,2
2462,12401,7,12408,3,12411,3
2459,12402,9,12411,3,12414,3
2463,12406,8,12414,3,12417,3
2464,12410,7,12417,3,12420,3
2465,12417,3,12420,3,12423,1
2466,12422,1,12423,3,12426,1
2467,12424,2,12426,3,12429,1
2466,12426,3,12429,3,12432,1
2468,12428,4,12432,3,12435,2
2469,12431,4,12435,3,12438,2
2468,12435,3,12438,3,12441,1
2470,12436,5,12441,3,12444,2
2468,12438,6,12444,3,12447,2
2468,12441,6,12447,3,12450,2
2471,12441,9,12450,3,12453,3
2472,12445,8,12453,3,12456,3
2473,12451,5,12456,3,12459,2
2474,12455,4,12459,3,12462,2
2472,12456,6,12462,3,12465,2
2475,12456,9,12465,3,12468,3
2476,12460,8,12468,3,12471,3
2477,12465,6,12471,3,12474,2
2475,12468,6,12474,3,12477,2
2478,12471,6,12477,3,12480,2
2479,12476,4,12480,3,12483,2
2477,12477,6,12483,3,12486,2
2480,12477,9,12486,3,12489,3
2481,12480,9,12489,3,12492,3
2482,12485,7,12492,3,12495,3
2479,12486,9,12495,3,12498,3
2483,12492,6,12498,3,12501,2
2481,12495,6,12501,3,12504,2
2484,12496,8,12504,3,12507,3
2485,12502,5,12507,3,12510,2
2483,12504,6,12510,3,12513,2
2486,12506,7,12513,3,12516,3
2487,12511,5,12516,3,12519,2
2488,12517,2,12519,3,12522,1
2487,12519,3,12522,3,12525,1
2489,12523,2,12525,3,12528,1
2488,12525,3,12528,3,12531,1
2490,12525,6,12531,3,12534,2
2491,12531,3,12534,3,12537,1
2490,12534,3,12537,3,12540,1
2492,12534,6,12540,3,12543,2
2493,12538,5,12543,3,12546,2
2494,12540,6,12546,3,12549,2
2495,12544,5,12549,3,12552,2
2496,12550,2,12552,3,12555,1
2497,12551,4,12555,3,12558,2
2495,12552,6,12558,3,12561,2
2495,12555,6,12561,3,12564,2
2498,12560,4,12564,3,12567,2
2496,12561,6,12567,3,12570,2
2499,12564,6,12570,3,12573,2
2500,12567,6,12573,3,12576,2
2498,12570,6,12576,3,12579,2
2498,12573,6,12579,3,12582,2
2501,12574,8,12582,3,12585,3
2498,12576,9,12585,3,12588,3
2498,12579,9,12588,3,12591,3
2502,12581,10,12591,3,12594,4
2503,12585,9,12594,3,12597,3
2504,12591,6,12597,3,12600,2
2505,12595,5,12600,3,12603,2
2506,12598,5,12603,3,12606,2
2507,12605,1,12606,3,12609,1
2508,12611,0,12611,3,12614,0
2509,12618,0,12618,3,12621,0
2509,12621,0,12621,3,12624,0
2510,12623,1,12624,3,12627,1
2510,12627,0,12627,3,12630,0
2511,12628,2,12630,3,12633,1
2512,12631,2,12633,3,12636,1
2511,12633,3,12636,3,12639,1
2513,12635,4,12639,3,12642,2
2514,12641,1,12642,3,12645,1
2515,12642,3,12645,3,12648,1
2516,12647,1,12648,3,12651,1
2515,12648,3,12651,3,12654,1
2515,12651,3,12654,3,12657,1
2517,12651,6,12657,3,12660,2
2518,12655,5,12660,3,12663,2
2519,12661,2,12663,3,12666,1
2520,12665,1,12666,3,12669,1
2519,12666,3,12669,3,12672,1
2521,12668,4,12672,3,12675,2
2522,12671,4,12675,3,12678,2
2523,12680,0,12680,3,12683,0
2524,12688,0,12688,3,12691,0
2525,12691,0,12691,3,12694,0
2526,12695,0,12695,3,12698,0
2527,12702,0,12702,3,12705,0
2528,12708,0,12708,3,12711,0
2529,12716,0,12716,3,12719,0
2530,12722,0,12722,3,12725,0
2531,12727,0,12727,3,12730,0
2532,12732,0,12732,3,12735,0
2532,12735,0,12735,3,12738,0
2532,12738,0,12738,3,12741,0
2533,12739,2,12741,3,12744,1
2534,12748,0,12748,3,12751,0
2535,12752,0,12752,3,12755,0
2536,12756,0,12756,3,12759,0
2536,12759,0,12759,3,12762,0
2537,12760,2,12762,3,12765,1
2538,12764,1,12765,3,12768,1
2539,12769,0,12769,3,12772,0
2539,12772,0,12772,3,12775,0
2540,12773,2,12775,3,12778,1
2541,12780,0,12780,3,12783,0
2542,12786,0,12786,3,12789,0
2543,12789,0,12789,3,12792,0
2543,12792,0,12792,3,12795,0
2543,12795,0,12795,3,12798,0
2544,12797,1,12798,3,12801,1
2545,12802,0,12802,3,12805,0
2546,12806,0,12806,3,12809,0
2547,12807,2,12809,3,12812,1
2547,12812,0,12812,3,12815,0
2548,12813,2,12815,3,12818,1
2549,12818,0,12818,3,12821,0
2550,12822,0,12822,3,12825,0
2551,12826,0,12826,3,12829,0
2552,12831,0,12831,3,12834,0
2553,12836,0,12836,3,12839,0
2554,12842,0,12842,3,12845,0
2555,12847,0,12847,3,12850,0
2556,12850,0,12850,3,12853,0
2557,12857,0,12857,3,12860,0
2558,12862,0,12862,3,12865,0
2559,12864,1,12865,3,12868,1
2558,12865,3,12868,3,12871,1
2560,12866,5,12871,3,12874,2
2559,12871,3,12874,3,12877,1
2561,12873,4,12877,3,12880,2
2559,12874,6,12880,3,12883,2
2562,12875,8,12883,3,12886,3
2559,12877,9,12886,3,12889,3
2563,12877,12,12889,3,12892,4
2564,12887,5,12892,3,12895,2
2565,12892,3,12895,3,12898,1
2566,12902,0,12902,3,12905,0
2567,12909,0,12909,3,12912,0
2568,12918,0,12918,3,12921,0
2569,12922,0,12922,3,12925,0
2570,12928,0,12928,3,12931,0
2571,12935,0,12935,3,12938,0
2571,12938,0,12938,3,12941,0
2572,12943,0,12943,3,12946,0
2573,12950,0,12950,3,12953,0
2574,12954,0,12954,3,12957,0
2575,12956,1,12957,3,12960,1
2576,12960,0,12960,3,12963,0
2577,12966,0,12966,3,12969,0
2578,12974,0,12974,3,12977,0
2579,12977,0,12977,3,12980,0
2579,12980,0,12980,3,12983,0
2579,12983,0,12983,3,12986,0
2580,12985,1,12986,3,12989,1
2581,12990,0,12990,3,12993,0
2581,12993,0,12993,3,12996,0
2582,12994,2,12996,3,12999,1
2581,12996,3,12999,3,13002,1
2583,12997,5,13002,3,13005,2
2584,12999,6,13005,3,13008,2
2585,13004,4,13008,3,13011,2
2583,13005,6,13011,3,13014,2
2586,13007,7,13014,3,13017,3
2585,13014,3,13017,3,13020,1
2587,13014,6,13020,3,13023,2
2586,13020,3,13023,3,13026,1
2588,13020,6,13026,3,13029,2
2589,13023,6,13029,3,13032,2
2590,13032,0,13032,3,13035,0
2591,13034,1,13035,3,13038,1
2592,13038,0,13038,3,13041,0
2592,13041,0,13041,3,13044,0
2593,13043,1,13044,3,13047,1
2592,13044,3,13047,3,13050,1
2594,13048,2,13050,3,13053,1
2593,13050,3,13053,3,13056,1
2595,13051,5,13056,3,13059,2
2596,13052,7,13059,3,13062,3
2593,13053,9,13062,3,13065,3
2594,13059,6,13065,3,13068,2
2597,13059,9,13068,3,13071,3
2596,13068,3,13071,3,13074,1
2598,13070,4,13074,3,13077,2
2599,13075,2,13077,3,13080,1
2599,13080,0,13080,3,13083,0
2600,13080,3,13083,3,13086,1
2599,13083,3,13086,3,13089,1
2601,13083,6,13089,3,13092,2
2600,13089,3,13092,3,13095,1
2602,13090,5,13095,3,13098,2
2603,13097,1,13098,3,13101,1
2604,13106,0,13106,3,13109,0
2605,13107,2,13109,3,13112,1
2604,13109,3,13112,3,13115,1
2606,13111,4,13115,3,13118,2
2604,13112,6,13118,3,13121,2
2607,13113,8,13121,3,13124,3
2608,13117,7,13124,3,13127,3
2609,13123,4,13127,3,13130,2
2608,13127,3,13130,3,13133,1
2608,13130,3,13133,3,13136,1
2610,13130,6,13136,3,13139,2
2611,13139,0,13139,3,13142,0
2611,13142,0,13142,3,13145,0
2611,13145,0,13145,3,13148,0
2612,13146,2,13148,3,13151,1
2611,13148,3,13151,3,13154,1
2613,13149,5,13154,3,13157,2
2614,13151,6,13157,3,13160,2
2612,13154,6,13160,3,13163,2
2615,13156,7,13163,3,13166,3
2616,13162,4,13166,3,13169,2
2614,13163,6,13169,3,13172,2
2617,13169,3,13172,3,13175,1
2618,13174,1,13175,3,13178,1
2618,13178,0,13178,3,13181,0
2619,13179,2,13181,3,13184,1
2620,13187,0,13187,3,13190,0
2621,13193,0,13193,3,13196,0
2621,13196,0,13196,3,13199,0
2622,13203,0,13203,3,13206,0
2623,13214,0,13214,3,13217,0
2624,13222,0,13222,3,13225,0
2625,13228,0,13228,3,13231,0
2626,13231,0,13231,3,13234,0
2626,13234,0,13234,3,13237,0
2627,13242,0,13242,3,13245,0
2628,13253,0,13253,3,13256,0
2629,13261,0,13261,3,13264,0
2630,13266,0,13266,3,13269,0
2631,13268,1,13269,3,13272,1
2632,13271,1,13272,3,13275,1
2632,13275,0,13275,3,13278,0
2633,13279,0,13279,3,13282,0
2633,13282,0,13282,3,13285,0
2634,13282,3,13285,3,13288,1
2635,13287,1,13288,3,13291,1
2634,13288,3,13291,3,13294,1
2635,13294,0,13294,3,13297,0
2636,13294,3,13297,3,13300,1
2637,13304,0,13304,3,13307,0
2638,13308,0,13308,3,13311,0
2639,13315,0,13315,3,13318,0
2640,13318,0,13318,3,13321,0
2641,13323,0,13323,3,13326,0
2642,13327,0,13327,3,13330,0
2643,13331,0,13331,3,13334,0
2644,13334,0,13334,3,13337,0
2644,13337,0,13337,3,13340,0
2644,13340,0,13340,3,13343,0
2645,13342,1,13343,3,13346,1
2644,13343,3,13346,3,13349,1
2646,13348,1,13349,3,13352,1
2645,13349,3,13352,3,13355,1
2647,13353,2,13355,3,13358,1
2648,13358,0,13358,3,13361,0
2649,13364,0,13364,3,13367,0
2650,13367,0,13367,3,13370,0
2651,13373,0,13373,3,13376,0
2652,13376,0,13376,3,13379,0
2653,13380,0,13380,3,13383,0
2654,13385,0,13385,3,13388,0
2655,13390,0,13390,3,13393,0
2656,13398,0,13398,3,13401,0
2657,13403,0,13403,3,13406,0
2657,13406,0,13406,3,13409,0
2658,13409,0,13409,3,13412,0
2659,13413,0,13413,3,13416,0
2660,13418,0,13418,3,13421,0
2661,13422,0,13422,3,13425,0
2662,13423,2,13425,3,13428,1
2663,13424,4,13428,3,13431,2
2661,13425,6,13431,3,13434,2
2664,13430,4,13434,3,13437,2
2665,13436,1,13437,3,13440,1
2666,13437,3,13440,3,13443,1
2667,13440,3,13443,3,13446,1
2668,13441,5,13446,3,13449,2
2669,13446,3,13449,3,13452,1
2669,13452,0,13452,3,13455,0
2670,13453,2,13455,3,13458,1
2671,13457,1,13458,3,13461,1
2672,13460,1,13461,3,13464,1
2673,13469,0,13469,3,13472,0
2673,13472,0,13472,3,13475,0
2673,13475,0,13475,3,13478,0
2674,13475,3,13478,3,13481,1
2674,13481,0,13481,3,13484,0
2675,13481,3,13484,3,13487,1
2674,13484,3,13487,3,13490,1
2676,13485,5,13490,3,13493,2
2677,13489,4,13493,3,13496,2
2678,13492,4,13496,3,13499,2
2679,13495,4,13499,3,13502,2
2680,13497,5,13502,3,13505,2
2681,13501,4,13505,3,13508,2
2679,13502,6,13508,3,13511,2
2682,13508,3,13511,3,13514,1
2683,13514,0,13514,3,13517,0
2684,13518,0,13518,3,13521,0
2685,13523,0,13523,3,13526,0
2686,13524,2,13526,3,13529,1
2687,13528,1,13529,3,13532,1
2688,13532,0,13532,3,13535,0
2689,13537,0,13537,3,13540,0
2690,13542,0,13542,3,13545,0
2691,13547,0,13547,3,13550,0
2692,13548,2,13550,3,13553,1
2693,13553,0,13553,3,13556,0
2693,13556,0,13556,3,13559,0
2694,13558,1,13559,3,13562,1
2695,13564,0,13564,3,13567,0
2696,13568,0,13568,3,13571,0
2697,13573,0,13573,3,13576,0
2698,13580,0,13580,3,13583,0
2699,13583,0,13583,3,13586,0
2699,13586,0,13586,3,13589,0
2700,13586,3,13589,3,13592,1
2699,13589,3,13592,3,13595,1
2700,13595,0,13595,3,13598,0
2701,13595,3,13598,3,13601,1
2702,13596,5,13601,3,13604,2
2703,13604,0,13604,3,13607,0
2704,13607,0,13607,3,13610,0
2705,13611,0,13611,3,13614,0
2706,13620,0,13620,3,13623,0
2707,13624,0,13624,3,13627,0
2707,13627,0,13627,3,13630,0
2708,13628,2,13630,3,13633,1
2707,13630,3,13633,3,13636,1
2707,13633,3,13636,3,13639,1
2707,13636,3,13639,3,13642,1
2709,13636,6,13642,3,13645,2
2707,13639,6,13645,3,13648,2
2710,13643,5,13648,3,13651,2
2711,13646,5,13651,3,13654,2
2709,13648,6,13654,3,13657,2
2712,13653,4,13657,3,13660,2
2710,13654,6,13660,3,13663,2
2710,13657,6,13663,3,13666,2
2713,13659,7,13666,3,13669,3
2710,13660,9,13669,3,13672,3
2714,13660,12,13672,3,13675,4
2715,13663,12,13675,3,13678,4
2716,13668,10,13678,3,13681,4
2717,13673,8,13681,3,13684,3
2718,13675,9,13684,3,13687,3
2715,13678,9,13687,3,13690,3
2719,13680,10,13690,3,13693,4
2720,13683,10,13693,3,13696,4
2721,13686,10,13696,3,13699,4
2722,13691,8,13699,3,13702,3
2719,13693,9,13702,3,13705,3
2723,13696,9,13705,3,13708,3
2724,13700,8,13708,3,13711,3
2725,13705,6,13711,3,13714,2
2726,13708,6,13714,3,13717,2
2727,13716,1,13717,3,13720,1
2728,13718,2,13720,3,13723,1
2729,13720,3,13723,3,13726,1
2730,13727,0,13727,3,13730,0
2731,13733,0,13733,3,13736,0
2732,13738,0,13738,3,13741,0
2733,13745,0,13745,3,13748,0
2734,13751,0,13751,3,13754,0
2735,13756,0,13756,3,13759,0
2735,13759,0,13759,3,13762,0
2736,13766,0,13766,3,13769,0
2737,13769,0,13769,3,13772,0
2738,13776,0,13776,3,13779,0
2739,13778,1,13779,3,13782,1
2740,13778,4,13782,3,13785,2
2741,13783,2,13785,3,13788,1
2742,13788,0,13788,3,13791,0
2743,13796,0,13796,3,13799,0
2744,13799,0,13799,3,13802,0
2745,13805,0,13805,3,13808,0
2746,13808,0,13808,3,13811,0
2747,13812,0,13812,3,13815,0
2748,13820,0,13820,3,13823,0
2749,13826,0,13826,3,13829,0
2750,13829,0,13829,3,13832,0
2751,13832,0,13832,3,13835,0
2751,13835,0,13835,3,13838,0
2752,13840,0,13840,3,13843,0
2752,13843,0,13843,3,13846,0
2753,13845,1,13846,3,13849,1
2752,13846,3,13849,3,13852,1
2754,13854,0,13854,3,13857,0
2755,13860,0,13860,3,13863,0
2755,13863,0,13863,3,13866,0
2756,13864,2,13866,3,13869,1
2757,13872,0,13872,3,13875,0
2758,13876,0,13876,3,13879,0
2759,13879,0,13879,3,13882,0
2760,13883,0,13883,3,13886,0
2760,13886,0,13886,3,13889,0
2761,13886,3,13889,3,13892,1
2762,13890,2,13892,3,13895,1
2763,13893,2,13895,3,13898,1
2764,13898,0,13898,3,13901,0
2764,13901,0,13901,3,13904,0
2764,13904,0,13904,3,13907,0
2765,13904,3,13907,3,13910,1
2766,13909,1,13910,3,13913,1
2767,13913,0,13913,3,13916,0
2768,13914,2,13916,3,13919,1
2768,13919,0,13919,3,13922,0
2769,13921,1,13922,3,13925,1
2770,13926,0,13926,3,13929,0
2770,13929,0,13929,3,13932,0
2771,13929,3,13932,3,13935,1
2772,13935,0,13935,3,13938,0
2773,13939,0,13939,3,13942,0
2774,13942,0,13942,3,13945,0
2775,13946,0,13946,3,13949,0
2775,13949,0,13949,3,13952,0
2776,13953,0,13953,3,13956,0
2777,13958,0,13958,3,13961,0
2778,13962,0,13962,3,13965,0
2779,13967,0,13967,3,13970,0
2780,13969,1,13970,3,13973,1
2781,13976,0,13976,3,13979,0
2781,13979,0,13979,3,13982,0
2782,13980,2,13982,3,13985,1
2783,13984,1,13985,3,13988,1
2784,13990,0,13990,3,13993,0
2784,13993,0,13993,3,13996,0
2785,13995,1,13996,3,13999,1
2786,14003,0,14003,3,14006,0
2787,14009,0,14009,3,14012,0
2787,14012,0,14012,3,14015,0
2788,14012,3,14015,3,14018,1
2789,14020,0,14020,3,14023,0
2789,14023,0,14023,3,14026,0
2790,14027,0,14027,3,14030,0
2791,14030,0,14030,3,14033,0
2791,14033,0,14033,3,14036,0
2792,14034,2,14036,3,14039,1
2793,14034,5,14039,3,14042,2
2794,14035,7,14042,3,14045,3
2791,14036,9,14045,3,14048,3
2795,14042,6,14048,3,14051,2
2796,14043,8,14051,3,14054,3
2797,14046,8,14054,3,14057,3
2794,14048,9,14057,3,14060,3
2798,14051,9,14060,3,14063,3
2799,14056,7,14063,3,14066,3
2800,14061,5,14066,3,14069,2
2798,14063,6,14069,3,14072,2
2801,14066,6,14072,3,14075,2
2802,14068,7,14075,3,14078,3
2800,14072,6,14078,3,14081,2
2803,14073,8,14081,3,14084,3
2800,14075,9,14084,3,14087,3
2800,14078,9,14087,3,14090,3
2800,14081,9,14090,3,14093,3
2804,14083,10,14093,3,14096,4
2805,14089,7,14096,3,14099,3
2806,14092,7,14099,3,14102,3
2807,14096,6,14102,3,14105,2
2808,14102,3,14105,3,14108,1
2809,14108,0,14108,3,14111,0
2810,14108,3,14111,3,14114,1
2811,14113,1,14114,3,14117,1
2810,14114,3,14117,3,14120,1
2811,14120,0,14120,3,14123,0
2812,14120,3,14123,3,14126,1
2813,14123,3,14126,3,14129,1
2814,14127,2,14129,3,14132,1
2815,14136,0,14136,3,14139,0
2815,14139,0,14139,3,14142,0
2815,14142,0,14142,3,14145,0
2816,14144,1,14145,3,14148,1
2815,14145,3,14148,3,14151,1
2816,14151,0,14151,3,14154,0
2817,14152,2,14154,3,14157,1
2818,14157,0,14157,3,14160,0
2819,14164,0,14164,3,14167,0
2820,14169,0,14169,3,14172,0
2821,14171,1,14172,3,14175,1
2822,14173,2,14175,3,14178,1
2821,14175,3,14178,3,14181,1
2823,14176,5,14181,3,14184,2
2822,14181,3,14184,3,14187,1
2824,14183,4,14187,3,14190,2
2823,14187,3,14190,3,14193,1
2825,14189,4,14193,3,14196,2
2823,14190,6,14196,3,14199,2
2823,14193,6,14199,3,14202,2
2826,14193,9,14202,3,14205,3
2827,14201,4,14205,3,14208,2
2826,14205,3,14208,3,14211,1
2828,14205,6,14211,3,14214,2
2826,14208,6,14214,3,14217,2
2829,14210,7,14217,3,14220,3
2830,14216,4,14220,3,14223,2
2831,14220,3,14223,3,14226,1
2832,14223,3,14226,3,14229,1
2833,14224,5,14229,3,14232,2
2834,14228,4,14232,3,14235,2
2833,14232,3,14235,3,14238,1
2835,14234,4,14238,3,14241,2
2836,14235,6,14241,3,14244,2
2837,14236,8,14244,3,14247,3
2838,14243,4,14247,3,14250,2
2839,14248,2,14250,3,14253,1
2838,14250,3,14253,3,14256,1
2840,14251,5,14256,3,14259,2
2838,14253,6,14259,3,14262,2
2841,14257,5,14262,3,14265,2
2842,14264,1,14265,3,14268,1
2841,14265,3,14268,3,14271,1
2841,14268,3,14271,3,14274,1
2843,14268,6,14274,3,14277,2
2841,14271,6,14277,3,14280,2
2841,14274,6,14280,3,14283,2
2844,14276,7,14283,3,14286,3
2845,14278,8,14286,3,14289,3
2846,14284,5,14289,3,14292,2
2845,14289,3,14292,3,14295,1
2847,14290,5,14295,3,14298,2
2848,14296,2,14298,3,14301,1
2849,14300,1,14301,3,14304,1
2850,14303,1,14304,3,14307,1
2851,14307,0,14307,3,14310,0
2851,14310,0,14310,3,14313,0
2852,14314,0,14314,3,14317,0
2853,14318,0,14318,3,14321,0
2853,14321,0,14321,3,14324,0
2854,14327,0,14327,3,14330,0
2855,14330,0,14330,3,14333,0
2856,14334,0,14334,3,14337,0
2857,14339,0,14339,3,14342,0
2857,14342,0,14342,3,14345,0
2858,14343,2,14345,3,14348,1
2859,14344,4,14348,3,14351,2
2860,14348,3,14351,3,14354,1
2859,14351,3,14354,3,14357,1
2859,14354,3,14357,3,14360,1
2861,14356,4,14360,3,14363,2
2862,14361,2,14363,3,14366,1
2862,14366,0,14366,3,14369,0
2863,14366,3,14369,3,14372,1
2864,14369,3,14372,3,14375,1
2865,14373,2,14375,3,14378,1
2866,14378,0,14378,3,14381,0
2867,14382,0,14382,3,14385,0
2868,14385,0,14385,3,14388,0
2868,14388,0,14388,3,14391,0
2869,14394,0,14394,3,14397,0
2870,14401,0,14401,3,14404,0
2871,14404,0,14404,3,14407,0
2872,14408,0,14408,3,14411,0
2873,14414,0,14414,3,14417,0
2874,14419,0,14419,3,14422,0
2875,14421,1,14422,3,14425,1
2876,14424,1,14425,3,14428,1
2875,14425,3,14428,3,14431,1
2877,14427,4,14431,3,14434,2
2878,14434,0,14434,3,14437,0
2879,14441,0,14441,3,14444,0
2879,14444,0,14444,3,14447,0
2880,14446,1,14447,3,14450,1
2879,14447,3,14450,3,14453,1
2881,14450,3,14453,3,14456,1
2881,14456,0,14456,3,14459,0
2882,14459,0,14459,3,14462,0
2882,14462,0,14462,3,14465,0
2883,14463,2,14465,3,14468,1
2883,14468,0,14468,3,14471,0
2884,14470,1,14471,3,14474,1
2885,14478,0,14478,3,14481,0
2886,14486,0,14486,3,14489,0
2887,14490,0,14490,3,14493,0
2887,14493,0,14493,3,14496,0
2888,14494,2,14496,3,14499,1
2889,14499,0,14499,3,14502,0
2890,14503,0,14503,3,14506,0
2891,14506,0,14506,3,14509,0
2892,14514,0,14514,3,14517,0
2893,14520,0,14520,3,14523,0
2894,14524,0,14524,3,14527,0
2894,14527,0,14527,3,14530,0
2895,14527,3,14530,3,14533,1
2896,14535,0,14535,3,14538,0
2897,14539,0,14539,3,14542,0
2898,14544,0,14544,3,14547,0
2899,14553,0,14553,3,14556,0
2900,14554,2,14556,3,14559,1
2900,14559,0,14559,3,14562,0
2901,14562,0,14562,3,14565,0
2902,14567,0,14567,3,14570,0
2903,14575,0,14575,3,14578,0
2904,14577,1,14578,3,14581,1
2904,14581,0,14581,3,14584,0
2904,14584,0,14584,3,14587,0
2905,14586,1,14587,3,14590,1
2906,14592,0,14592,3,14595,0
2906,14595,0,14595,3,14598,0
2907,14595,3,14598,3,14601,1
2906,14598,3,14601,3,14604,1
2908,14598,6,14604,3,14607,2
2906,14601,6,14607,3,14610,2
2909,14603,7,14610,3,14613,3
2907,14607,6,14613,3,14616,2
2910,14607,9,14616,3,14619,3
2907,14610,9,14619,3,14622,3
2911,14611,11,14622,3,14625,4
2910,14622,3,14625,3,14628,1
2910,14625,3,14628,3,14631,1
2912,14625,6,14631,3,14634,2
2913,14630,4,14634,3,14637,2
2913,14637,0,14637,3,14640,0
2914,14637,3,14640,3,14643,1
2913,14640,3,14643,3,14646,1
2915,14641,5,14646,3,14649,2
2916,14648,1,14649,3,14652,1
2916,14652,0,14652,3,14655,0
2917,14654,1,14655,3,14658,1
2918,14658,0,14658,3,14661,0
2919,14662,0,14662,3,14665,0
2920,14669,0,14669,3,14672,0
2920,14672,0,14672,3,14675,0
2921,14677,0,14677,3,14680,0
2921,14680,0,14680,3,14683,0
2922,14682,1,14683,3,14686,1
2923,14684,2,14686,3,14689,1
2924,14687,2,14689,3,14692,1
2925,14690,2,14692,3,14695,1
2926,14694,1,14695,3,14698,1
2927,14700,0,14700,3,14703,0
2928,14703,0,14703,3,14706,0
2929,14706,0,14706,3,14709,0
2930,14711,0,14711,3,14714,0
2931,14716,0,14716,3,14719,0
2931,14719,0,14719,3,14722,0
2932,14723,0,14723,3,14726,0
2933,14730,0,14730,3,14733,0
2934,14736,0,14736,3,14739,0
2935,14736,3,14739,3,14742,1
2934,14739,3,14742,3,14745,1
2936,14739,6,14745,3,14748,2
2937,14745,3,14748,3,14751,1
2938,14748,3,14751,3,14754,1
2939,14749,5,14754,3,14757,2
2937,14751,6,14757,3,14760,2
2937,14754,6,14760,3,14763,2
2940,14757,6,14763,3,14766,2
2938,14760,6,14766,3,14769,2
2941,14763,6,14769,3,14772,2
2942,14769,3,14772,3,14775,1
2943,14775,0,14775,3,14778,0
2944,14786,0,14786,3,14789,0
2945,14792,0,14792,3,14795,0
2946,14799,0,14799,3,14802,0
2946,14802,0,14802,3,14805,0
2947,14810,0,14810,3,14813,0
2948,14812,1,14813,3,14816,1
2947,14813,3,14816,3,14819,1
2949,14817,2,14819,3,14822,1
2950,14820,2,14822,3,14825,1
2951,14823,2,14825,3,14828,1
2950,14825,3,14828,3,14831,1
2952,14828,3,14831,3,14834,1
2952,14834,0,14834,3,14837,0
2953,14834,3,14837,3,14840,1
2954,14840,0,14840,3,14843,0
2955,14848,0,14848,3,14851,0
2955,14851,0,14851,3,14854,0
2956,14853,1,14854,3,14857,1
2955,14854,3,14857,3,14860,1
2957,14857,3,14860,3,14863,1
2958,14863,0,14863,3,14866,0
2959,14869,0,14869,3,14872,0
2960,14876,0,14876,3,14879,0
2960,14879,0,14879,3,14882,0
2961,14880,2,14882,3,14885,1
2961,14885,0,14885,3,14888,0
2962,14885,3,14888,3,14891,1
2963,14887,4,14891,3,14894,2
2961,14888,6,14894,3,14897,2
2964,14895,2,14897,3,14900,1
2965,14899,1,14900,3,14903,1
2964,14900,3,14903,3,14906,1
2966,14902,4,14906,3,14909,2
2967,14904,5,14909,3,14912,2
2968,14911,1,14912,3,14915,1
2969,14919,0,14919,3,14922,0
2970,14921,1,14922,3,14925,1
2970,14925,0,14925,3,14928,0
2971,14927,1,14928,3,14931,1
2971,14931,0,14931,3,14934,0
2972,14934,0,14934,3,14937,0
2972,14937,0,14937,3,14940,0
2973,14938,2,14940,3,14943,1
2974,14941,2,14943,3,14946,1
2973,14943,3,14946,3,14949,1
2975,14944,5,14949,3,14952,2
2976,14947,5,14952,3,14955,2
2977,14948,7,14955,3,14958,3
2978,14953,5,14958,3,14961,2
2977,14958,3,14961,3,14964,1
2979,14964,0,14964,3,14967,0
2980,14967,0,14967,3,14970,0
2980,14970,0,14970,3,14973,0
2981,14972,1,14973,3,14976,1
2982,14978,0,14978,3,14981,0
2983,14982,0,14982,3,14985,0
2984,14987,0,14987,3,14990,0
2985,14992,0,14992,3,14995,0
2986,14994,1,14995,3,14998,1
2987,15004,0,15004,3,15007,0
2988,15012,0,15012,3,15015,0
2989,15020,0,15020,3,15023,0
2990,15025,0,15025,3,15028,0
2990,15028,0,15028,3,15031,0
2991,15030,1,15031,3,15034,1
2990,15031,3,15034,3,15037,1
2992,15032,5,15037,3,15040,2
2990,15034,6,15040,3,15043,2
2993,15038,5,15043,3,15046,2
2994,15045,1,15046,3,15049,1
2994,15049,0,15049,3,15052,0
2995,15056,0,15056,3,15059,0
2995,15059,0,15059,3,15062,0
2996,15060,2,15062,3,15065,1
2997,15066,0,15066,3,15069,0
2998,15073,0,15073,3,15076,0
2999,15078,0,15078,3,15081,0
3000,15083,0,15083,3,15086,0
3001,15088,0,15088,3,15091,0
3002,15096,0,15096,3,15099,0
3002,15099,0,15099,3,15102,0
3002,15102,0,15102,3,15105,0
3003,15102,3,15105,3,15108,1
3002,15105,3,15108,3,15111,1
3004,15105,6,15111,3,15114,2
3005,15113,1,15114,3,15117,1
3006,15114,3,15117,3,15120,1
3005,15117,3,15120,3,15123,1
3007,15121,2,15123,3,15126,1
3008,15127,0,15127,3,15130,0
3009,15134,0,15134,3,15137,0
3009,15137,0,15137,3,15140,0
3010,15137,3,15140,3,15143,1
3009,15140,3,15143,3,15146,1
3009,15143,3,15146,3,15149,1
3011,15143,6,15149,3,15152,2
3009,15146,6,15152,3,15155,2
3012,15146,9,15155,3,15158,3
3009,15149,9,15158,3,15161,3
3009,15152,9,15161,3,15164,3
3013,15154,10,15164,3,15167,4
3009,15155,12,15167,3,15170,4
3009,15158,12,15170,3,15173,4
3014,15159,14,15173,3,15176,5
3015,15163,13,15176,3,15179,5
3016,15165,14,15179,3,15182,5
3011,15167,15,15182,3,15185,5
3017,15169,16,15185,3,15188,6
3018,15173,15,15188,3,15191,5
3013,15176,15,15191,3,15194,5
3019,15177,17,15194,3,15197,6
3020,15178,19,15197,3,15200,7
3014,15182,18,15200,3,15203,6
3021,15184,19,15203,3,15206,7
3015,15188,18,15206,3,15209,6
3016,15194,15,15209,3,15212,5
3022,15194,18,15212,3,15215,6
3023,15197,18,15215,3,15218,6
3024,15205,13,15218,3,15221,5
3019,15206,15,15221,3,15224,5
3025,15209,15,15224,3,15227,5
3026,15210,17,15227,3,15230,6
3021,15215,15,15230,3,15233,5
3027,15215,18,15233,3,15236,6
3028,15217,19,15236,3,15239,7
3021,15218,21,15239,3,15242,7
3029,15223,19,15242,3,15245,7
3022,15224,21,15245,3,15248,7
3030,15226,22,15248,3,15251,8
3031,15231,20,15251,3,15254,7
3024,15233,21,15254,3,15257,7
3032,15235,22,15257,3,15260,8
3033,15237,23,15260,3,15263,8
3025,15239,24,15263,3,15266,8
3034,15240,26,15266,3,15269,9
3025,15242,27,15269,3,15272,9
3035,15245,27,15272,3,15275,9
3027,15251,24,15275,3,15278,8
3036,15253,25,15278,3,15281,9
3027,15254,27,15281,3,15284,9
3037,15254,30,15284,3,15287,10
3027,15257,30,15287,3,15290,10
3038,15262,28,15290,3,15293,10
3039,15265,28,15293,3,15296,10
3029,15266,30,15296,3,15299,10
3029,15269,30,15299,3,15302,10
3040,15269,33,15302,3,15305,11
3029,15272,33,15305,3,15308,11
3029,15275,33,15308,3,15311,11
3041,15276,35,15311,3,15314,12
3029,15278,36,15314,3,15317,12
3029,15281,36,15317,3,15320,12
3042,15285,35,15320,3,15323,12
3030,15287,36,15323,3,15326,12
3043,15290,36,15326,3,15329,12
3044,15293,36,15329,3,15332,12
3045,15295,37,15332,3,15335,13
3034,15302,33,15335,3,15338,11
3046,15302,36,15338,3,15341,12
3047,15307,34,15341,3,15344,12
3036,15311,33,15344,3,15347,11
3048,15313,34,15347,3,15350,12
3049,15314,36,15350,3,15353,12
3037,15317,36,15353,3,15356,12
3050,15319,37,15356,3,15359,13
3051,15320,39,15359,3,15362,13
3052,15325,37,15362,3,15365,13
3053,15328,37,15365,3,15368,13
3040,15329,39,15368,3,15371,13
3054,15331,40,15371,3,15374,14
3055,15333,41,15374,3,15377,14
3056,15334,43,15377,3,15380,15
3043,15341,39,15380,3,15383,13
3057,15342,41,15383,3,15386,14
3058,15348,38,15386,3,15389,13
3059,15350,39,15389,3,15392,13
3046,15353,39,15392,3,15395,13
3060,15358,37,15395,3,15398,13
3061,15362,36,15398,3,15401,12
3051,15371,30,15401,3,15404,10
3062,15371,33,15404,3,15407,11
3063,15373,34,15407,3,15410,12
3064,15380,30,15410,3,15413,10
3065,15388,25,15413,3,15416,9
3056,15389,27,15416,3,15419,9
3066,15393,26,15419,3,15422,9
3067,15397,25,15422,3,15425,9
3059,15401,24,15425,3,15428,8
3068,15401,27,15428,3,15431,9
3069,15408,23,15431,3,15434,8
3070,15415,19,15434,3,15437,7
3064,15419,18,15437,3,15440,6
3071,15419,21,15440,3,15443,7
3072,15425,18,15443,3,15446,6
3073,15429,17,15446,3,15449,6
3074,15433,16,15449,3,15452,6
3075,15436,16,15452,3,15455,6
3076,15437,18,15455,3,15458,6
3077,15444,14,15458,3,15461,5
3078,15451,10,15461,3,15464,4
3074,15452,12,15464,3,15467,4
3079,15453,14,15467,3,15470,5
3080,15459,11,15470,3,15473,4
3081,15463,10,15473,3,15476,4
3082,15469,7,15476,3,15479,3
3079,15470,9,15479,3,15482,3
3083,15474,8,15482,3,15485,3
3084,15483,2,15485,3,15488,1
3084,15488,0,15488,3,15491,0
3085,15488,3,15491,3,15494,1
3086,15492,2,15494,3,15497,1
3087,15496,1,15497,3,15500,1
3088,15500,0,15500,3,15503,0
3089,15508,0,15508,3,15511,0
3090,15511,0,15511,3,15514,0
3091,15519,0,15519,3,15522,0
3091,15522,0,15522,3,15525,0
3092,15528,0,15528,3,15531,0
3093,15532,0,15532,3,15535,0
3093,15535,0,15535,3,15538,0
3094,15536,2,15538,3,15541,1
3094,15541,0,15541,3,15544,0
3095,15543,1,15544,3,15547,1
3096,15548,0,15548,3,15551,0
3097,15554,0,15554,3,15557,0
3097,15557,0,15557,3,15560,0
3098,15562,0,15562,3,15565,0
3098,15565,0,15565,3,15568,0
3099,15566,2,15568,3,15571,1
3100,15572,0,15572,3,15575,0
3101,15576,0,15576,3,15579,0
3102,15581,0,15581,3,15584,0
3103,15585,0,15585,3,15588,0
3104,15587,1,15588,3,15591,1
3105,15595,0,15595,3,15598,0
3106,15602,0,15602,3,15605,0
3107,15603,2,15605,3,15608,1
3106,15605,3,15608,3,15611,1
3108,15609,2,15611,3,15614,1
3107,15611,3,15614,3,15617,1
3108,15617,0,15617,3,15620,0
3109,15619,1,15620,3,15623,1
3108,15620,3,15623,3,15626,1
3110,15622,4,15626,3,15629,2
3108,15623,6,15629,3,15632,2
3111,15628,4,15632,3,15635,2
3109,15629,6,15635,3,15638,2
3112,15636,2,15638,3,15641,1
3112,15641,0,15641,3,15644,0
3113,15643,1,15644,3,15647,1
3112,15644,3,15647,3,15650,1
3112,15647,3,15650,3,15653,1
3114,15647,6,15653,3,15656,2
3113,15653,3,15656,3,15659,1
3115,15654,5,15659,3,15662,2
3116,15660,2,15662,3,15665,1
3117,15668,0,15668,3,15671,0
3117,15671,0,15671,3,15674,0
3118,15671,3,15674,3,15677,1
3118,15677,0,15677,3,15680,0
3119,15677,3,15680,3,15683,1
3120,15680,3,15683,3,15686,1
3121,15683,3,15686,3,15689,1
3120,15686,3,15689,3,15692,1
3122,15687,5,15692,3,15695,2
3123,15691,4,15695,3,15698,2
3124,15698,0,15698,3,15701,0
3124,15701,0,15701,3,15704,0
3124,15704,0,15704,3,15707,0
3125,15704,3,15707,3,15710,1
3125,15710,0,15710,3,15713,0
3126,15710,3,15713,3,15716,1
3127,15712,4,15716,3,15719,2
3125,15713,6,15719,3,15722,2
3125,15716,6,15722,3,15725,2
3128,15720,5,15725,3,15728,2
3129,15725,3,15728,3,15731,1
3130,15728,3,15731,3,15734,1
3131,15734,0,15734,3,15737,0
3131,15737,0,15737,3,15740,0
3132,15738,2,15740,3,15743,1
3131,15740,3,15743,3,15746,1
3133,15746,0,15746,3,15749,0
3134,15753,0,15753,3,15756,0
3135,15758,0,15758,3,15761,0
3136,15763,0,15763,3,15766,0
3137,15768,0,15768,3,15771,0
3137,15771,0,15771,3,15774,0
3138,15771,3,15774,3,15777,1
3139,15774,3,15777,3,15780,1
3140,15780,0,15780,3,15783,0
3141,15785,0,15785,3,15788,0
3141,15788,0,15788,3,15791,0
3142,15789,2,15791,3,15794,1
3143,15794,0,15794,3,15797,0
3143,15797,0,15797,3,15800,0
3144,15799,1,15800,3,15803,1
3145,15805,0,15805,3,15808,0
3146,15813,0,15813,3,15816,0
3147,15817,0,15817,3,15820,0
3148,15820,0,15820,3,15823,0
3148,15823,0,15823,3,15826,0
3149,15827,0,15827,3,15830,0
3149,15830,0,15830,3,15833,0
3149,15833,0,15833,3,15836,0
3150,15833,3,15836,3,15839,1
3149,15836,3,15839,3,15842,1
3151,15840,2,15842,3,15845,1
3152,15843,2,15845,3,15848,1
3153,15845,3,15848,3,15851,1
3154,15849,2,15851,3,15854,1
3155,15852,2,15854,3,15857,1
3156,15858,0,15858,3,15861,0
3157,15862,0,15862,3,15865,0
3158,15863,2,15865,3,15868,1
3157,15865,3,15868,3,15871,1
3159,15865,6,15871,3,15874,2
3160,15867,7,15874,3,15877,3
3161,15873,4,15877,3,15880,2
3160,15877,3,15880,3,15883,1
3162,15877,6,15883,3,15886,2
3163,15884,2,15886,3,15889,1
3164,15889,0,15889,3,15892,0
3164,15892,0,15892,3,15895,0
3165,15898,0,15898,3,15901,0
3166,15905,0,15905,3,15908,0
3167,15912,0,15912,3,15915,0
3167,15915,0,15915,3,15918,0
3168,15916,2,15918,3,15921,1
3168,15921,0,15921,3,15924,0
3169,15922,2,15924,3,15927,1
3169,15927,0,15927,3,15930,0
3170,15929,1,15930,3,15933,1
3170,15933,0,15933,3,15936,0
3171,15933,3,15936,3,15939,1
3172,15939,0,15939,3,15942,0
3173,15945,0,15945,3,15948,0
3173,15948,0,15948,3,15951,0
3174,15954,0,15954,3,15957,0
3175,15959,0,15959,3,15962,0
3176,15961,1,15962,3,15965,1
3175,15962,3,15965,3,15968,1
3177,15964,4,15968,3,15971,2
3178,15968,3,15971,3,15974,1
3177,15971,3,15974,3,15977,1
3179,15975,2,15977,3,15980,1
3179,15980,0,15980,3,15983,0
3180,15981,2,15983,3,15986,1
3181,15985,1,15986,3,15989,1
3180,15986,3,15989,3,15992,1
3182,15992,0,15992,3,15995,0
3182,15995,0,15995,3,15998,0
3183,15996,2,15998,3,16001,1
3183,16001,0,16001,3,16004,0
3184,16001,3,16004,3,16007,1
3185,16008,0,16008,3,16011,0
3185,16011,0,16011,3,16014,0
3186,16011,3,16014,3,16017,1
3187,16016,1,16017,3,16020,1
3188,16019,1,16020,3,16023,1
3189,16024,0,16024,3,16027,0
3190,16027,0,16027,3,16030,0
3191,16028,2,16030,3,16033,1
3190,16030,3,16033,3,16036,1
3190,16033,3,16036,3,16039,1
3192,16033,6,16039,3,16042,2
3193,16040,2,16042,3,16045,1
3194,16045,0,16045,3,16048,0
3195,16048,0,16048,3,16051,0
3195,16051,0,16051,3,16054,0
3196,16053,1,16054,3,16057,1
3197,16055,2,16057,3,16060,1
3198,16058,2,16060,3,16063,1
3199,16061,2,16063,3,16066,1
3198,16063,3,16066,3,16069,1
3200,16065,4,16069,3,16072,2
3198,16066,6,16072,3,16075,2
3198,16069,6,16075,3,16078,2
3198,16072,6,16078,3,16081,2
3201,16072,9,16081,3,16084,3
3202,16076,8,16084,3,16087,3
3199,16078,9,16087,3,16090,3
3203,16084,6,16090,3,16093,2
3204,16088,5,16093,3,16096,2
3203,16093,3,16096,3,16099,1
3205,16094,5,16099,3,16102,2
3206,16098,4,16102,3,16105,2
3204,16099,6,16105,3,16108,2
3207,16107,1,16108,3,16111,1
3206,16108,3,16111,3,16114,1
3208,16115,0,16115,3,16118,0
3209,16119,0,16119,3,16122,0
3210,16124,0,16124,3,16127,0
3211,16129,0,16129,3,16132,0
3212,16131,1,16132,3,16135,1
3211,16132,3,16135,3,16138,1
3213,16135,3,16138,3,16141,1
3214,16137,4,16141,3,16144,2
3212,16138,6,16144,3,16147,2
3215,16140,7,16147,3,16150,3
3216,16143,7,16150,3,16153,3
3217,16147,6,16153,3,16156,2
3215,16150,6,16156,3,16159,2
3218,16151,8,16159,3,16162,3
3219,16156,6,16162,3,16165,2
3220,16156,9,16165,3,16168,3
3221,16162,6,16168,3,16171,2
3220,16168,3,16171,3,16174,1
3222,16168,6,16174,3,16177,2
3223,16172,5,16177,3,16180,2
3224,16175,5,16180,3,16183,2
3225,16182,1,16183,3,16186,1
3226,16189,0,16189,3,16192,0
3227,16191,1,16192,3,16195,1
3228,16194,1,16195,3,16198,1
3228,16198,0,16198,3,16201,0
3229,16201,0,16201,3,16204,0
3230,16203,1,16204,3,16207,1
3231,16206,1,16207,3,16210,1
3232,16206,4,16210,3,16213,2
3233,16213,0,16213,3,16216,0
3234,16219,0,16219,3,16222,0
3235,16226,0,16226,3,16229,0
3236,16228,1,16229,3,16232,1
3236,16232,0,16232,3,16235,0
3237,16235,0,16235,3,16238,0
3238,16239,0,16239,3,16242,0
3239,16243,0,16243,3,16246,0
3239,16246,0,16246,3,16249,0
3240,16249,0,16249,3,16252,0
3241,16254,0,16254,3,16257,0
3242,16261,0,16261,3,16264,0
3243,16265,0,16265,3,16268,0
3244,16270,0,16270,3,16273,0
3245,16274,0,16274,3,16277,0
3246,16277,0,16277,3,16280,0
3247,16280,0,16280,3,16283,0
3248,16284,0,16284,3,16287,0
3249,16289,0,16289,3,16292,0
3249,16292,0,16292,3,16295,0
3250,16294,1,16295,3,16298,1
3249,16295,3,16298,3,16301,1
3249,16298,3,16301,3,16304,1
3251,16298,6,16304,3,16307,2
3252,16303,4,16307,3,16310,2
3253,16309,1,16310,3,16313,1
3252,16310,3,16313,3,16316,1
3254,16314,2,16316,3,16319,1
3255,16317,2,16319,3,16322,1
3256,16321,1,16322,3,16325,1
3255,16322,3,16325,3,16328,1
3257,16324,4,16328,3,16331,2
3256,16328,3,16331,3,16334,1
3258,16331,3,16334,3,16337,1
3259,16334,3,16337,3,16340,1
3258,16337,3,16340,3,16343,1
3260,16341,2,16343,3,16346,1
3261,16346,0,16346,3,16349,0
3261,16349,0,16349,3,16352,0
3262,16354,0,16354,3,16357,0
3263,16362,0,16362,3,16365,0
3263,16365,0,16365,3,16368,0
3264,16365,3,16368,3,16371,1
3265,16368,3,16371,3,16374,1
3264,16371,3,16374,3,16377,1
3266,16373,4,16377,3,16380,2
3267,16377,3,16380,3,16383,1
3268,16378,5,16383,3,16386,2
3266,16380,6,16386,3,16389,2
3269,16380,9,16389,3,16392,3
3270,16389,3,16392,3,16395,1
3269,16392,3,16395,3,16398,1
3271,16393,5,16398,3,16401,2
3272,16398,3,16401,3,16404,1
3273,16402,2,16404,3,16407,1
3272,16404,3,16407,3,16410,1
3274,16407,3,16410,3,16413,1
3275,16411,2,16413,3,16416,1
3274,16413,3,16416,3,16419,1
3276,16417,2,16419,3,16422,1
3277,16424,0,16424,3,16427,0
3278,16425,2,16427,3,16430,1
3279,16431,0,16431,3,16434,0
3280,16437,0,16437,3,16440,0
3280,16440,0,16440,3,16443,0
3281,16441,2,16443,3,16446,1
3282,16444,2,16446,3,16449,1
3281,16446,3,16449,3,16452,1
3283,16446,6,16452,3,16455,2
3281,16449,6,16455,3,16458,2
3284,16449,9,16458,3,16461,3
3285,16458,3,16461,3,16464,1
3284,16461,3,16464,3,16467,1
3286,16465,2,16467,3,16470,1
3286,16470,0,16470,3,16473,0
3287,16472,1,16473,3,16476,1
3288,16476,0,16476,3,16479,0
3289,16483,0,16483,3,16486,0
3290,16489,0,16489,3,16492,0
3291,16493,0,16493,3,16496,0
3292,16503,0,16503,3,16506,0
3293,16508,0,16508,3,16511,0
3294,16514,0,16514,3,16517,0
3295,16523,0,16523,3,16526,0
3295,16526,0,16526,3,16529,0
3296,16529,0,16529,3,16532,0
3297,16535,0,16535,3,16538,0
3298,16542,0,16542,3,16545,0
3298,16545,0,16545,3,16548,0
3299,16547,1,16548,3,16551,1
3300,16551,0,16551,3,16554,0
3301,16555,0,16555,3,16558,0
3302,16560,0,16560,3,16563,0
3303,16562,1,16563,3,16566,1
3304,16564,2,16566,3,16569,1
3305,16571,0,16571,3,16574,0
3305,16574,0,16574,3,16577,0
3306,16577,0,16577,3,16580,0
3307,16579,1,16580,3,16583,1
3308,16584,0,16584,3,16587,0
3308,16587,0,16587,3,16590,0
3308,16590,0,16590,3,16593,0
3309,16592,1,16593,3,16596,1
3310,16596,0,16596,3,16599,0
3310,16599,0,16599,3,16602,0
3310,16602,0,16602,3,16605,0
3311,16603,2,16605,3,16608,1
3311,16608,0,16608,3,16611,0
3312,16608,3,16611,3,16614,1
3313,16612,2,16614,3,16617,1
3314,16617,0,16617,3,16620,0
3314,16620,0,16620,3,16623,0
3315,16620,3,16623,3,16626,1
3315,16626,0,16626,3,16629,0
3316,16630,0,16630,3,16633,0
3317,16636,0,16636,3,16639,0
3318,16641,0,16641,3,16644,0
3319,16644,0,16644,3,16647,0
3320,16648,0,16648,3,16651,0
3320,16651,0,16651,3,16654,0
3321,16655,0,16655,3,16658,0
3322,16661,0,16661,3,16664,0
3323,16664,0,16664,3,16667,0
3324,16668,0,16668,3,16671,0
3325,16669,2,16671,3,16674,1
3326,16672,2,16674,3,16677,1
3327,16673,4,16677,3,16680,2
3328,16679,1,16680,3,16683,1
3329,16681,2,16683,3,16686,1
3330,16685,1,16686,3,16689,1
3331,16686,3,16689,3,16692,1
3332,16688,4,16692,3,16695,2
3330,16689,6,16695,3,16698,2
3330,16692,6,16698,3,16701,2
3333,16692,9,16701,3,16704,3
3334,16698,6,16704,3,16707,2
3335,16700,7,16707,3,16710,3
3332,16701,9,16710,3,16713,3
3336,16705,8,16713,3,16716,3
3337,16709,7,16716,3,16719,3
3338,16711,8,16719,3,16722,3
3337,16719,3,16722,3,16725,1
3339,16719,6,16725,3,16728,2
3340,16724,4,16728,3,16731,2
3338,16725,6,16731,3,16734,2
3339,16731,3,16734,3,16737,1
3341,16731,6,16737,3,16740,2
3342,16738,2,16740,3,16743,1
3343,16744,0,16744,3,16747,0
3343,16747,0,16747,3,16750,0
3344,16748,2,16750,3,16753,1
3343,16750,3,16753,3,16756,1
3345,16753,3,16756,3,16759,1
3344,16756,3,16759,3,16762,1
3346,16761,1,16762,3,16765,1
3347,16766,0,16766,3,16769,0
3348,16776,0,16776,3,16779,0
3349,16780,0,16780,3,16783,0
3350,16785,0,16785,3,16788,0
3351,16792,0,16792,3,16795,0
3351,16795,0,16795,3,16798,0
3351,16798,0,16798,3,16801,0
3352,16798,3,16801,3,16804,1
3353,16802,2,16804,3,16807,1
3354,16806,1,16807,3,16810,1
3355,16814,0,16814,3,16817,0
3355,16817,0,16817,3,16820,0
3356,16819,1,16820,3,16823,1
3357,16826,0,16826,3,16829,0
3358,16834,0,16834,3,16837,0
3359,16838,0,16838,3,16841,0
3360,16844,0,16844,3,16847,0
3360,16847,0,16847,3,16850,0
3361,16847,3,16850,3,16853,1
3360,16850,3,16853,3,16856,1
3362,16853,3,16856,3,16859,1
3363,16863,0,16863,3,16866,0
3363,16866,0,16866,3,16869,0
3364,16870,0,16870,3,16873,0
3364,16873,0,16873,3,16876,0
3365,16876,0,16876,3,16879,0
3366,16878,1,16879,3,16882,1
3367,16883,0,16883,3,16886,0
3368,16885,1,16886,3,16889,1
3369,16894,0,16894,3,16897,0
3369,16897,0,16897,3,16900,0
3370,16901,0,16901,3,16904,0
3370,16904,0,16904,3,16907,0
3371,16908,0,16908,3,16911,0
3372,16917,0,16917,3,16920,0
3373,16920,0,16920,3,16923,0
3374,16926,0,16926,3,16929,0
3375,16937,0,16937,3,16940,0
3376,16940,0,16940,3,16943,0
3377,16946,0,16946,3,16949,0
3378,16951,0,16951,3,16954,0
3378,16954,0,16954,3,16957,0
3379,16960,0,16960,3,16963,0
3379,16963,0,16963,3,16966,0
3379,16966,0,16966,3,16969,0
3379,16969,0,16969,3,16972,0
3380,16969,3,16972,3,16975,1
3381,16974,1,16975,3,16978,1
3382,16979,0,16979,3,16982,0
3382,16982,0,16982,3,16985,0
3383,16985,0,16985,3,16988,0
3384,16986,2,16988,3,16991,1
3385,16990,1,16991,3,16994,1
3386,16994,0,16994,3,16997,0
3387,16996,1,16997,3,17000,1
3388,17000,0,17000,3,17003,0
3388,17003,0,17003,3,17006,0
3389,17006,0,17006,3,17009,0
3390,17012,0,17012,3,17015,0
3391,17018,0,17018,3,17021,0
3391,17021,0,17021,3,17024,0
3392,17023,1,17024,3,17027,1
3391,17024,3,17027,3,17030,1
3393,17029,1,17030,3,17033,1
3394,17033,0,17033,3,17036,0
3395,17039,0,17039,3,17042,0
3395,17042,0,17042,3,17045,0
3396,17042,3,17045,3,17048,1
3397,17049,0,17049,3,17052,0
3398,17051,1,17052,3,17055,1
3397,17052,3,17055,3,17058,1
3399,17057,1,17058,3,17061,1
3398,17058,3,17061,3,17064,1
3400,17060,4,17064,3,17067,2
3398,17061,6,17067,3,17070,2
3398,17064,6,17070,3,17073,2
3401,17068,5,17073,3,17076,2
3402,17072,4,17076,3,17079,2
3403,17077,2,17079,3,17082,1
3404,17080,2,17082,3,17085,1
3405,17081,4,17085,3,17088,2
3403,17082,6,17088,3,17091,2
3406,17089,2,17091,3,17094,1
3407,17094,0,17094,3,17097,0
3408,17102,0,17102,3,17105,0
3408,17105,0,17105,3,17108,0
3409,17107,1,17108,3,17111,1
3410,17112,0,17112,3,17115,0
3411,17116,0,17116,3,17119,0
3412,17123,0,17123,3,17126,0
3412,17126,0,17126,3,17129,0
3413,17129,0,17129,3,17132,0
3414,17131,1,17132,3,17135,1
3414,17135,0,17135,3,17138,0
3415,17138,0,17138,3,17141,0
3416,17146,0,17146,3,17149,0
3417,17148,1,17149,3,17152,1
3416,17149,3,17152,3,17155,1
3417,17155,0,17155,3,17158,0
3418,17155,3,17158,3,17161,1
3417,17158,3,17161,3,17164,1
3419,17158,6,17164,3,17167,2
3420,17159,8,17167,3,17170,3
3421,17165,5,17170,3,17173,2
3419,17167,6,17173,3,17176,2
3422,17167,9,17176,3,17179,3
3423,17175,4,17179,3,17182,2
3421,17176,6,17182,3,17185,2
3424,17182,3,17185,3,17188,1
3424,17188,0,17188,3,17191,0
3425,17188,3,17191,3,17194,1
3426,17189,5,17194,3,17197,2
3427,17192,5,17197,3,17200,2
3425,17194,6,17200,3,17203,2
3428,17196,7,17203,3,17206,3
3425,17197,9,17206,3,17209,3
3426,17203,6,17209,3,17212,2
3429,17204,8,17212,3,17215,3
3430,17208,7,17215,3,17218,3
3427,17209,9,17218,3,17221,3
3431,17212,9,17221,3,17224,3
3432,17219,5,17224,3,17227,2
3430,17221,6,17227,3,17230,2
3430,17224,6,17230,3,17233,2
3430,17227,6,17233,3,17236,2
3433,17227,9,17236,3,17239,3
3430,17230,9,17239,3,17242,3
3434,17234,8,17242,3,17245,3
3435,17238,7,17245,3,17248,3
3436,17241,7,17248,3,17251,3
3437,17246,5,17251,3,17254,2
3438,17253,1,17254,3,17257,1
3438,17257,0,17257,3,17260,0
3439,17257,3,17260,3,17263,1
3440,17258,5,17263,3,17266,2
3441,17259,7,17266,3,17269,3
3438,17260,9,17269,3,17272,3
3442,17263,9,17272,3,17275,3
3439,17266,9,17275,3,17278,3
3443,17270,8,17278,3,17281,3
3444,17275,6,17281,3,17284,2
3445,17278,6,17284,3,17287,2
3443,17281,6,17287,3,17290,2
3446,17283,7,17290,3,17293,3
3447,17288,5,17293,3,17296,2
3448,17295,1,17296,3,17299,1
3449,17300,0,17300,3,17303,0
3450,17305,0,17305,3,17308,0
3450,17308,0,17308,3,17311,0
3451,17310,1,17311,3,17314,1
3452,17311,3,17314,3,17317,1
3452,17317,0,17317,3,17320,0
3453,17317,3,17320,3,17323,1
3454,17320,3,17323,3,17326,1
3455,17322,4,17326,3,17329,2
3456,17324,5,17329,3,17332,2
3454,17326,6,17332,3,17335,2
3454,17329,6,17335,3,17338,2
3457,17330,8,17338,3,17341,3
3458,17335,6,17341,3,17344,2
3459,17339,5,17344,3,17347,2
3457,17341,6,17347,3,17350,2
3457,17344,6,17350,3,17353,2
3460,17344,9,17353,3,17356,3
3457,17347,9,17356,3,17359,3
3457,17350,9,17359,3,17362,3
3461,17352,10,17362,3,17365,4
3462,17353,12,17365,3,17368,4
3463,17359,9,17368,3,17371,3
3464,17363,8,17371,3,17374,3
3465,17364,10,17374,3,17377,4
3462,17368,9,17377,3,17380,3
3466,17370,10,17380,3,17383,4
3463,17374,9,17383,3,17386,3
3463,17377,9,17386,3,17389,3
3467,17379,10,17389,3,17392,4
3464,17383,9,17392,3,17395,3
3468,17385,10,17395,3,17398,4
3465,17389,9,17398,3,17401,3
3469,17395,6,17401,3,17404,2
3470,17403,1,17404,3,17407,1
3470,17407,0,17407,3,17410,0
3471,17408,2,17410,3,17413,1
3472,17411,2,17413,3,17416,1
3473,17415,1,17416,3,17419,1
3473,17419,0,17419,3,17422,0
3474,17421,1,17422,3,17425,1
3475,17428,0,17428,3,17431,0
3476,17431,0,17431,3,17434,0
3477,17439,0,17439,3,17442,0
3478,17441,1,17442,3,17445,1
3479,17445,0,17445,3,17448,0
3480,17450,0,17450,3,17453,0
3481,17454,0,17454,3,17457,0
3482,17458,0,17458,3,17461,0
3483,17466,0,17466,3,17469,0
3483,17469,0,17469,3,17472,0
3484,17471,1,17472,3,17475,1
3485,17476,0,17476,3,17479,0
3486,17480,0,17480,3,17483,0
3486,17483,0,17483,3,17486,0
3487,17486,0,17486,3,17489,0
3487,17489,0,17489,3,17492,0
3488,17493,0,17493,3,17496,0
3488,17496,0,17496,3,17499,0
3489,17498,1,17499,3,17502,1
3490,17502,0,17502,3,17505,0
3491,17506,0,17506,3,17509,0
3492,17511,0,17511,3,17514,0
3492,17514,0,17514,3,17517,0
3493,17517,0,17517,3,17520,0
3494,17521,0,17521,3,17524,0
3495,17526,0,17526,3,17529,0
3496,17529,0,17529,3,17532,0
3497,17535,0,17535,3,17538,0
3498,17538,0,17538,3,17541,0
3498,17541,0,17541,3,17544,0
3498,17544,0,17544,3,17547,0
3499,17544,3,17547,3,17550,1
3498,17547,3,17550,3,17553,1
3500,17550,3,17553,3,17556,1
3499,17553,3,17556,3,17559,1
3499,17556,3,17559,3,17562,1
3501,17558,4,17562,3,17565,2
3499,17559,6,17565,3,17568,2
3502,17565,3,17568,3,17571,1
3503,17570,1,17571,3,17574,1
3504,17577,0,17577,3,17580,0
3505,17581,0,17581,3,17584,0
3506,17584,0,17584,3,17587,0
3507,17590,0,17590,3,17593,0
3508,17592,1,17593,3,17596,1
3509,17594,2,17596,3,17599,1
3508,17596,3,17599,3,17602,1
3510,17597,5,17602,3,17605,2
3508,17599,6,17605,3,17608,2
3511,17600,8,17608,3,17611,3
3512,17603,8,17611,3,17614,3
3513,17606,8,17614,3,17617,3
3510,17608,9,17617,3,17620,3
3510,17611,9,17620,3,17623,3
3514,17612,11,17623,3,17626,4
3510,17614,12,17626,3,17629,4
3515,17615,14,17629,3,17632,5
3510,17617,15,17632,3,17635,5
3516,17617,18,17635,3,17638,6
3517,17622,16,17638,3,17641,6
3518,17629,12,17641,3,17644,4
3515,17635,9,17644,3,17647,3
3519,17636,11,17647,3,17650,4
3516,17641,9,17650,3,17653,3
3520,17641,12,17653,3,17656,4
3521,17646,10,17656,3,17659,4
3522,17648,11,17659,3,17662,4
3523,17654,8,17662,3,17665,3
3524,17656,9,17665,3,17668,3
3525,17660,8,17668,3,17671,3
3523,17665,6,17671,3,17674,2
3526,17666,8,17674,3,17677,3
3527,17668,9,17677,3,17680,3
3528,17671,9,17680,3,17683,3
3529,17674,9,17683,3,17686,3
3530,17678,8,17686,3,17689,3
3527,17680,9,17689,3,17692,3
3531,17685,7,17692,3,17695,3
3529,17689,6,17695,3,17698,2
3532,17690,8,17698,3,17701,3
3533,17698,3,17701,3,17704,1
3534,17700,4,17704,3,17707,2
3532,17701,6,17707,3,17710,2
3532,17704,6,17710,3,17713,2
3535,17704,9,17713,3,17716,3
3536,17711,5,17716,3,17719,2
3537,17717,2,17719,3,17722,1
3536,17719,3,17722,3,17725,1
3536,17722,3,17725,3,17728,1
3538,17723,5,17728,3,17731,2
3539,17730,1,17731,3,17734,1
3538,17731,3,17734,3,17737,1
3540,17738,0,17738,3,17741,0
3541,17742,0,17742,3,17745,0
3541,17745,0,17745,3,17748,0
3542,17749,0,17749,3,17752,0
3543,17757,0,17757,3,17760,0
3544,17764,0,17764,3,17767,0
3544,17767,0,17767,3,17770,0
3545,17771,0,17771,3,17774,0
3546,17778,0,17778,3,17781,0
3546,17781,0,17781,3,17784,0
3547,17781,3,17784,3,17787,1
3548,17783,4,17787,3,17790,2
3549,17788,2,17790,3,17793,1
3550,17789,4,17793,3,17796,2
3551,17791,5,17796,3,17799,2
3551,17799,0,17799,3,17802,0
3552,17799,3,17802,3,17805,1
3551,17802,3,17805,3,17808,1
3553,17804,4,17808,3,17811,2
3551,17805,6,17811,3,17814,2
3554,17808,6,17814,3,17817,2
3553,17814,3,17817,3,17820,1
3555,17815,5,17820,3,17823,2
3556,17818,5,17823,3,17826,2
3557,17824,2,17826,3,17829,1
3558,17826,3,17829,3,17832,1
3559,17832,0,17832,3,17835,0
3560,17837,0,17837,3,17840,0
3561,17843,0,17843,3,17846,0
3562,17849,0,17849,3,17852,0
3562,17852,0,17852,3,17855,0
3563,17853,2,17855,3,17858,1
3564,17857,1,17858,3,17861,1
3565,17863,0,17863,3,17866,0
3566,17872,0,17872,3,17875,0
3567,17877,0,17877,3,17880,0
3568,17884,0,17884,3,17887,0
3569,17889,0,17889,3,17892,0
3570,17901,0,17901,3,17904,0
3570,17904,0,17904,3,17907,0
3571,17906,1,17907,3,17910,1
3570,17907,3,17910,3,17913,1
3572,17912,1,17913,3,17916,1
3571,17913,3,17916,3,17919,1
3573,17917,2,17919,3,17922,1
3574,17924,0,17924,3,17927,0
3575,17931,0,17931,3,17934,0
3576,17935,0,17935,3,17938,0
3577,17937,1,17938,3,17941,1
3578,17940,1,17941,3,17944,1
3578,17944,0,17944,3,17947,0
3579,17944,3,17947,3,17950,1
3580,17944,6,17950,3,17953,2
3581,17953,0,17953,3,17956,0
3582,17957,0,17957,3,17960,0
3583,17964,0,17964,3,17967,0
3584,17970,0,17970,3,17973,0
3584,17973,0,17973,3,17976,0
3585,17973,3,17976,3,17979,1
3586,17981,0,17981,3,17984,0
3587,17984,0,17984,3,17987,0
3588,17990,0,17990,3,17993,0
3588,17993,0,17993,3,17996,0
3589,17994,2,17996,3,17999,1
3589,17999,0,17999,3,18002,0
3590,17999,3,18002,3,18005,1
3589,18002,3,18005,3,18008,1
3591,18007,1,18008,3,18011,1
3590,18008,3,18011,3,18014,1
3590,18011,3,18014,3,18017,1
3592,18011,6,18017,3,18020,2
3593,18012,8,18020,3,18023,3
3591,18017,6,18023,3,18026,2
3594,18017,9,18026,3,18029,3
3595,18022,7,18029,3,18032,3
3592,18023,9,18032,3,18035,3
3593,18029,6,18035,3,18038,2
3596,18030,8,18038,3,18041,3
3597,18034,7,18041,3,18044,3
3598,18039,5,18044,3,18047,2
3599,18045,2,18047,3,18050,1
3598,18047,3,18050,3,18053,1
3598,18050,3,18053,3,18056,1
3600,18052,4,18056,3,18059,2
3598,18053,6,18059,3,18062,2
3598,18056,6,18062,3,18065,2
3601,18057,8,18065,3,18068,3
3599,18062,6,18068,3,18071,2
3602,18062,9,18071,3,18074,3
3599,18065,9,18074,3,18077,3
3603,18067,10,18077,3,18080,4
3604,18071,9,18080,3,18083,3
3605,18075,8,18083,3,18086,3
3602,18077,9,18086,3,18089,3
3606,18079,10,18089,3,18092,4
3602,18080,12,18092,3,18095,4
3607,18084,11,18095,3,18098,4
3608,18092,6,18098,3,18101,2
3606,18095,6,18101,3,18104,2
3609,18096,8,18104,3,18107,3
3606,18098,9,18107,3,18110,3
3610,18105,5,18110,3,18113,2
3611,18110,3,18113,3,18116,1
3612,18113,3,18116,3,18119,1
3613,18115,4,18119,3,18122,2
3614,18121,1,18122,3,18125,1
3615,18127,0,18127,3,18130,0
3616,18131,0,18131,3,18134,0
3617,18135,0,18135,3,18138,0
3618,18140,0,18140,3,18143,0
3619,18150,0,18150,3,18153,0
3620,18156,0,18156,3,18159,0
3621,18158,1,18159,3,18162,1
3622,18165,0,18165,3,18168,0
3623,18165,3,18168,3,18171,1
3624,18169,2,18171,3,18174,1
3623,18171,3,18174,3,18177,1
3625,18172,5,18177,3,18180,2
3626,18178,2,18180,3,18183,1
3627,18183,0,18183,3,18186,0
3628,18188,0,18188,3,18191,0
3629,18195,0,18195,3,18198,0
3630,18202,0,18202,3,18205,0
3631,18205,0,18205,3,18208,0
3632,18211,0,18211,3,18214,0
3632,18214,0,18214,3,18217,0
3633,18216,1,18217,3,18220,1
3634,18223,0,18223,3,18226,0
3635,18229,0,18229,3,18232,0
3636,18234,0,18234,3,18237,0
3637,18239,0,18239,3,18242,0
3638,18241,1,18242,3,18245,1
3639,18242,3,18245,3,18248,1
3638,18245,3,18248,3,18251,1
3640,18246,5,18251,3,18254,2
3641,18249,5,18254,3,18257,2
3641,18257,0,18257,3,18260,0
3642,18257,3,18260,3,18263,1
3643,18262,1,18263,3,18266,1
3642,18263,3,18266,3,18269,1
3644,18268,1,18269,3,18272,1
3645,18273,0,18273,3,18276,0
3646,18275,1,18276,3,18279,1
3645,18276,3,18279,3,18282,1
3647,18278,4,18282,3,18285,2
3648,18285,0,18285,3,18288,0
3648,18288,0,18288,3,18291,0
3649,18290,1,18291,3,18294,1
3649,18294,0,18294,3,18297,0
3650,18294,3,18297,3,18300,1
3649,18297,3,18300,3,18303,1
3651,18301,2,18303,3,18306,1
3650,18303,3,18306,3,18309,1
3652,18307,2,18309,3,18312,1
3653,18309,3,18312,3,18315,1
3652,18312,3,18315,3,18318,1
3654,18315,3,18318,3,18321,1
3655,18322,0,18322,3,18325,0
3655,18325,0,18325,3,18328,0
3655,18328,0,18328,3,18331,0
3656,18330,1,18331,3,18334,1
3655,18331,3,18334,3,18337,1
3657,18335,2,18337,3,18340,1
3658,18338,2,18340,3,18343,1
3659,18347,0,18347,3,18350,0
3660,18351,0,18351,3,18354,0
3661,18355,0,18355,3,18358,0
3662,18359,0,18359,3,18362,0
3662,18362,0,18362,3,18365,0
3663,18365,0,18365,3,18368,0
3664,18370,0,18370,3,18373,0
3665,18373,0,18373,3,18376,0
3666,18383,0,18383,3,18386,0
3667,18390,0,18390,3,18393,0
3668,18393,0,18393,3,18396,0
3669,18398,0,18398,3,18401,0
3670,18404,0,18404,3,18407,0
3671,18413,0,18413,3,18416,0
3672,18419,0,18419,3,18422,0
3672,18422,0,18422,3,18425,0
3672,18425,0,18425,3,18428,0
3673,18427,1,18428,3,18431,1
3673,18431,0,18431,3,18434,0
3674,18431,3,18434,3,18437,1
3675,18434,3,18437,3,18440,1
3676,18436,4,18440,3,18443,2
3675,18440,3,18443,3,18446,1
3675,18443,3,18446,3,18449,1
3677,18443,6,18449,3,18452,2
3678,18445,7,18452,3,18455,3
3675,18446,9,18455,3,18458,3
3679,18451,7,18458,3,18461,3
3677,18455,6,18461,3,18464,2
3680,18457,7,18464,3,18467,3
3681,18462,5,18467,3,18470,2
3679,18464,6,18470,3,18473,2
3682,18467,6,18473,3,18476,2
3683,18472,4,18476,3,18479,2
3682,18476,3,18479,3,18482,1
3684,18476,6,18482,3,18485,2
3685,18478,7,18485,3,18488,3
3686,18484,4,18488,3,18491,2
3687,18486,5,18491,3,18494,2
3685,18488,6,18494,3,18497,2
3688,18489,8,18497,3,18500,3
3689,18498,2,18500,3,18503,1
3690,18500,3,18503,3,18506,1
3689,18503,3,18506,3,18509,1
3689,18506,3,18509,3,18512,1
3691,18507,5,18512,3,18515,2
3692,18515,0,18515,3,18518,0
3693,18519,0,18519,3,18522,0
3694,18523,0,18523,3,18526,0
3694,18526,0,18526,3,18529,0
3695,18530,0,18530,3,18533,0
3696,18533,0,18533,3,18536,0
3696,18536,0,18536,3,18539,0
3697,18536,3,18539,3,18542,1
3698,18540,2,18542,3,18545,1
3699,18541,4,18545,3,18548,2
3700,18543,5,18548,3,18551,2
3698,18545,6,18551,3,18554,2
3701,18546,8,18554,3,18557,3
3702,18557,0,18557,3,18560,0
3703,18559,1,18560,3,18563,1
3702,18560,3,18563,3,18566,1
3704,18562,4,18566,3,18569,2
3705,18566,3,18569,3,18572,1
3706,18571,1,18572,3,18575,1
3707,18574,1,18575,3,18578,1
3706,18575,3,18578,3,18581,1
3707,18581,0,18581,3,18584,0
3708,18582,2,18584,3,18587,1
3709,18587,0,18587,3,18590,0
3709,18590,0,18590,3,18593,0
3710,18590,3,18593,3,18596,1
3711,18596,0,18596,3,18599,0
3712,18597,2,18599,3,18602,1
3713,18599,3,18602,3,18605,1
3714,18610,0,18610,3,18613,0
3715,18611,2,18613,3,18616,1
3714,18613,3,18616,3,18619,1
3716,18616,3,18619,3,18622,1
3715,18619,3,18622,3,18625,1
3715,18622,3,18625,3,18628,1
3717,18623,5,18628,3,18631,2
3718,18633,0,18633,3,18636,0
3719,18638,0,18638,3,18641,0
3720,18643,0,18643,3,18646,0
3721,18648,0,18648,3,18651,0
3722,18653,0,18653,3,18656,0
3723,18660,0,18660,3,18663,0
3724,18665,0,18665,3,18668,0
3725,18667,1,18668,3,18671,1
3724,18668,3,18671,3,18674,1
3726,18672,2,18674,3,18677,1
3725,18674,3,18677,3,18680,1
3727,18677,3,18680,3,18683,1
3726,18680,3,18683,3,18686,1
3728,18685,1,18686,3,18689,1
3728,18689,0,18689,3,18692,0
3729,18691,1,18692,3,18695,1
3730,18691,4,18695,3,18698,2
3729,18695,3,18698,3,18701,1
3729,18698,3,18701,3,18704,1
3731,18701,3,18704,3,18707,1
3732,18706,1,18707,3,18710,1
3733,18709,1,18710,3,18713,1
3732,18710,3,18713,3,18716,1
3734,18714,2,18716,3,18719,1
3734,18719,0,18719,3,18722,0
3735,18719,3,18722,3,18725,1
3736,18724,1,18725,3,18728,1
3737,18731,0,18731,3,18734,0
3737,18734,0,18734,3,18737,0
3737,18737,0,18737,3,18740,0
3738,18737,3,18740,3,18743,1
3739,18741,2,18743,3,18746,1
3740,18746,0,18746,3,18749,0
3741,18750,0,18750,3,18753,0
3742,18755,0,18755,3,18758,0
3743,18759,0,18759,3,18762,0
3743,18762,0,18762,3,18765,0
3744,18763,2,18765,3,18768,1
3743,18765,3,18768,3,18771,1
3745,18765,6,18771,3,18774,2
3744,18771,3,18774,3,18777,1
3746,18773,4,18777,3,18780,2
3747,18774,6,18780,3,18783,2
3748,18778,5,18783,3,18786,2
3747,18783,3,18786,3,18789,1
3749,18789,0,18789,3,18792,0
3749,18792,0,18792,3,18795,0
3750,18797,0,18797,3,18800,0
3751,18798,2,18800,3,18803,1
3752,18800,3,18803,3,18806,1
3751,18803,3,18806,3,18809,1
3751,18806,3,18809,3,18812,1
3753,18806,6,18812,3,18815,2
3751,18809,6,18815,3,18818,2
3754,18812,6,18818,3,18821,2
3755,18814,7,18821,3,18824,3
3752,18815,9,18824,3,18827,3
3752,18818,9,18827,3,18830,3
3756,18823,7,18830,3,18833,3
3757,18824,9,18833,3,18836,3
3754,18827,9,18836,3,18839,3
3758,18829,10,18839,3,18842,4
3754,18830,12,18842,3,18845,4
3754,18833,12,18845,3,18848,4
3759,18834,14,18848,3,18851,5
3755,18839,12,18851,3,18854,4
3760,18841,13,18854,3,18857,5
3761,18848,9,18857,3,18860,3
3758,18851,9,18860,3,18863,3
3762,18852,11,18863,3,18866,4
3763,18856,10,18866,3,18869,4
3764,18860,9,18869,3,18872,3
3761,18863,9,18872,3,18875,3
3765,18864,11,18875,3,18878,4
3761,18866,12,18878,3,18881,4
3766,18870,11,18881,3,18884,4
3767,18873,11,18884,3,18887,4
3768,18875,12,18887,3,18890,4
3769,18880,10,18890,3,18893,4
3765,18881,12,18893,3,18896,4
3770,18884,12,18896,3,18899,4
3766,18887,12,18899,3,18902,4
3771,18887,15,18902,3,18905,5
3772,18893,12,18905,3,18908,4
3768,18896,12,18908,3,18911,4
3773,18900,11,18911,3,18914,4
3774,18902,12,18914,3,18917,4
3775,18906,11,18917,3,18920,4
3776,18911,9,18920,3,18923,3
3777,18915,8,18923,3,18926,3
3778,18921,5,18926,3,18929,2
3776,18923,6,18929,3,18932,2
3776,18926,6,18932,3,18935,2
3779,18926,9,18935,3,18938,3
3780,18933,5,18938,3,18941,2
3781,18936,5,18941,3,18944,2
3780,18941,3,18944,3,18947,1
3780,18944,3,18947,3,18950,1
3782,18944,6,18950,3,18953,2
3780,18947,6,18953,3,18956,2
3783,18949,7,18956,3,18959,3
3780,18950,9,18959,3,18962,3
3784,18952,10,18962,3,18965,4
3785,18954,11,18965,3,18968,4
3782,18959,9,18968,3,18971,3
3786,18959,12,18971,3,18974,4
3787,18964,10,18974,3,18977,4
3783,18965,12,18977,3,18980,4
3788,18968,12,18980,3,18983,4
3785,18974,9,18983,3,18986,3
3789,18974,12,18986,3,18989,4
3790,18977,12,18989,3,18992,4
3786,18980,12,18992,3,18995,4
3791,18980,15,18995,3,18998,5
3792,18980,18,18998,3,19001,6
3793,18986,15,19001,3,19004,5
3794,18987,17,19004,3,19007,6
3795,18991,16,19007,3,19010,6
3796,18994,16,19010,3,19013,6
3790,18995,18,19013,3,19016,6
3797,18998,18,19016,3,19019,6
3792,19004,15,19019,3,19022,5
3798,19004,18,19022,3,19025,6
3793,19010,15,19025,3,19028,5
3799,19011,17,19028,3,19031,6
3800,19016,15,19031,3,19034,5
3801,19020,14,19034,3,19037,5
3796,19022,15,19037,3,19040,5
3796,19025,15,19040,3,19043,5
3802,19025,18,19043,3,19046,6
3803,19031,15,19046,3,19049,5
3804,19039,10,19049,3,19052,4
3800,19040,12,19052,3,19055,4
3805,19042,13,19055,3,19058,5
3806,19044,14,19058,3,19061,5
3807,19048,13,19061,3,19064,5
3808,19051,13,19064,3,19067,5
3803,19052,15,19067,3,19070,5
3809,19056,14,19070,3,19073,5
3805,19061,12,19073,3,19076,4
3810,19063,13,19076,3,19079,5
3811,19065,14,19079,3,19082,5
3807,19070,12,19082,3,19085,4
3812,19070,15,19085,3,19088,5
3813,19074,14,19088,3,19091,5
3808,19076,15,19091,3,19094,5
3814,19078,16,19094,3,19097,6
3815,19084,13,19097,3,19100,5
3816,19090,10,19100,3,19103,4
3817,19094,9,19103,3,19106,3
3818,19101,5,19106,3,19109,2
3816,19103,6,19109,3,19112,2
3819,19106,6,19112,3,19115,2
3817,19109,6,19115,3,19118,2
3820,19110,8,19118,3,19121,3
3821,19113,8,19121,3,19124,3
3822,19121,3,19124,3,19127,1
3821,19124,3,19127,3,19130,1
3823,19128,2,19130,3,19133,1
3824,19135,0,19135,3,19138,0
3824,19138,0,19138,3,19141,0
3825,19138,3,19141,3,19144,1
3826,19144,0,19144,3,19147,0
3827,19146,1,19147,3,19150,1
3828,19149,1,19150,3,19153,1
3829,19154,0,19154,3,19157,0
3830,19164,0,19164,3,19167,0
3830,19167,0,19167,3,19170,0
3831,19169,1,19170,3,19173,1
3830,19170,3,19173,3,19176,1
3832,19174,2,19176,3,19179,1
3833,19177,2,19179,3,19182,1
3834,19181,1,19182,3,19185,1
3833,19182,3,19185,3,19188,1
3835,19184,4,19188,3,19191,2
3836,19189,2,19191,3,19194,1
3835,19191,3,19194,3,19197,1
3837,19191,6,19197,3,19200,2
3838,19198,2,19200,3,19203,1
3839,19200,3,19203,3,19206,1
3840,19204,2,19206,3,19209,1
3841,19208,1,19209,3,19212,1
3842,19212,0,19212,3,19215,0
3843,19215,0,19215,3,19218,0
3844,19221,0,19221,3,19224,0
3845,19223,1,19224,3,19227,1
3844,19224,3,19227,3,19230,1
3844,19227,3,19230,3,19233,1
3846,19227,6,19233,3,19236,2
3847,19234,2,19236,3,19239,1
3848,19241,0,19241,3,19244,0
3849,19249,0,19249,3,19252,0
3850,19255,0,19255,3,19258,0
3850,19258,0,19258,3,19261,0
3851,19258,3,19261,3,19264,1
3850,19261,3,19264,3,19267,1
3852,19262,5,19267,3,19270,2
3852,19270,0,19270,3,19273,0
3853,19270,3,19273,3,19276,1
3854,19278,0,19278,3,19281,0
3855,19283,0,19283,3,19286,0
3855,19286,0,19286,3,19289,0
3856,19289,0,19289,3,19292,0
3856,19292,0,19292,3,19295,0
3856,19295,0,19295,3,19298,0
3857,19296,2,19298,3,19301,1
3856,19298,3,19301,3,19304,1
3858,19302,2,19304,3,19307,1
3857,19304,3,19307,3,19310,1
3859,19308,2,19310,3,19313,1
3858,19310,3,19313,3,19316,1
3860,19310,6,19316,3,19319,2
3861,19314,5,19319,3,19322,2
3862,19322,0,19322,3,19325,0
3863,19326,0,19326,3,19329,0
3864,19329,0,19329,3,19332,0
3864,19332,0,19332,3,19335,0
3865,19333,2,19335,3,19338,1
3866,19339,0,19339,3,19342,0
3867,19342,0,19342,3,19345,0
3868,19343,2,19345,3,19348,1
3869,19347,1,19348,3,19351,1
3868,19348,3,19351,3,19354,1
3870,19353,1,19354,3,19357,1
3869,19354,3,19357,3,19360,1
3871,19358,2,19360,3,19363,1
3870,19360,3,19363,3,19366,1
3872,19362,4,19366,3,19369,2
3870,19363,6,19369,3,19372,2
3870,19366,6,19372,3,19375,2
3873,19369,6,19375,3,19378,2
3874,19371,7,19378,3,19381,3
3871,19372,9,19381,3,19384,3
3875,19376,8,19384,3,19387,3
3872,19378,9,19387,3,19390,3
3876,19379,11,19390,3,19393,4
3877,19381,12,19393,3,19396,4
3878,19384,12,19396,3,19399,4
3874,19387,12,19399,3,19402,4
3879,19388,14,19402,3,19405,5
3880,19391,14,19405,3,19408,5
3881,19395,13,19408,3,19411,5
3878,19402,9,19411,3,19414,3
3882,19402,12,19414,3,19417,4
3883,19410,7,19417,3,19420,3
3884,19416,4,19420,3,19423,2
3883,19420,3,19423,3,19426,1
3885,19421,5,19426,3,19429,2
3886,19428,1,19429,3,19432,1
3886,19432,0,19432,3,19435,0
3887,19432,3,19435,3,19438,1
3888,19436,2,19438,3,19441,1
3887,19438,3,19441,3,19444,1
3889,19440,4,19444,3,19447,2
3888,19444,3,19447,3,19450,1
3890,19444,6,19450,3,19453,2
3889,19450,3,19453,3,19456,1
3891,19451,5,19456,3,19459,2
3892,19457,2,19459,3,19462,1
3893,19463,0,19463,3,19466,0
3894,19469,0,19469,3,19472,0
3895,19476,0,19476,3,19479,0
3896,19481,0,19481,3,19484,0
3897,19484,0,19484,3,19487,0
3898,19489,0,19489,3,19492,0
3899,19496,0,19496,3,19499,0
3899,19499,0,19499,3,19502,0
3900,19501,1,19502,3,19505,1
3901,19505,0,19505,3,19508,0
3901,19508,0,19508,3,19511,0
3902,19511,0,19511,3,19514,0
3903,19513,1,19514,3,19517,1
3904,19515,2,19517,3,19520,1
3903,19517,3,19520,3,19523,1
3905,19517,6,19523,3,19526,2
3906,19519,7,19526,3,19529,3
3904,19523,6,19529,3,19532,2
3907,19524,8,19532,3,19535,3
3908,19529,6,19535,3,19538,2
3906,19532,6,19538,3,19541,2
3909,19533,8,19541,3,19544,3
3910,19538,6,19544,3,19547,2
3911,19545,2,19547,3,19550,1
3910,19547,3,19550,3,19553,1
3910,19550,3,19553,3,19556,1
3912,19552,4,19556,3,19559,2
3910,19553,6,19559,3,19562,2
3913,19555,7,19562,3,19565,3
3914,19561,4,19565,3,19568,2
3915,19562,6,19568,3,19571,2
3916,19564,7,19571,3,19574,3
3913,19565,9,19574,3,19577,3
3917,19571,6,19577,3,19580,2
3916,19577,3,19580,3,19583,1
3918,19577,6,19583,3,19586,2
3919,19582,4,19586,3,19589,2
3920,19585,4,19589,3,19592,2
3918,19586,6,19592,3,19595,2
3921,19587,8,19595,3,19598,3
3918,19589,9,19598,3,19601,3
3922,19594,7,19601,3,19604,3
3923,19603,1,19604,3,19607,1
3924,19610,0,19610,3,19613,0
3925,19613,0,19613,3,19616,0
3926,19616,0,19616,3,19619,0
3926,19619,0,19619,3,19622,0
3926,19622,0,19622,3,19625,0
3927,19623,2,19625,3,19628,1
3928,19627,1,19628,3,19631,1
3927,19628,3,19631,3,19634,1
3929,19630,4,19634,3,19637,2
3930,19637,0,19637,3,19640,0
3930,19640,0,19640,3,19643,0
3931,19649,0,19649,3,19652,0
3932,19653,0,19653,3,19656,0
3933,19655,1,19656,3,19659,1
3934,19657,2,19659,3,19662,1
3935,19660,2,19662,3,19665,1
3936,19667,0,19667,3,19670,0
3937,19672,0,19672,3,19675,0
3938,19681,0,19681,3,19684,0
3939,19683,1,19684,3,19687,1
3940,19688,0,19688,3,19691,0
3941,19690,1,19691,3,19694,1
3942,19691,3,19694,3,19697,1
3943,19697,0,19697,3,19700,0
3943,19700,0,19700,3,19703,0
3943,19703,0,19703,3,19706,0
3944,19703,3,19706,3,19709,1
3945,19709,0,19709,3,19712,0
3946,19711,1,19712,3,19715,1
3946,19715,0,19715,3,19718,0
3947,19718,0,19718,3,19721,0
3947,19721,0,19721,3,19724,0
3947,19724,0,19724,3,19727,0
3948,19726,1,19727,3,19730,1
3947,19727,3,19730,3,19733,1
3949,19732,1,19733,3,19736,1
3949,19736,0,19736,3,19739,0
3950,19736,3,19739,3,19742,1
3951,19747,0,19747,3,19750,0
3952,19751,0,19751,3,19754,0
3953,19754,0,19754,3,19757,0
3954,19760,0,19760,3,19763,0
3955,19767,0,19767,3,19770,0
3956,19774,0,19774,3,19777,0
3957,19780,0,19780,3,19783,0
3958,19786,0,19786,3,19789,0
3959,19788,1,19789,3,19792,1
3958,19789,3,19792,3,19795,1
3960,19795,0,19795,3,19798,0
3961,19802,0,19802,3,19805,0
3962,19805,0,19805,3,19808,0
3963,19808,0,19808,3,19811,0
3964,19813,0,19813,3,19816,0
3965,19815,1,19816,3,19819,1
3965,19819,0,19819,3,19822,0
3966,19819,3,19822,3,19825,1
3967,19821,4,19825,3,19828,2
3968,19821,7,19828,3,19831,3
3969,19823,8,19831,3,19834,3
3966,19825,9,19834,3,19837,3
3970,19828,9,19837,3,19840,3
3971,19835,5,19840,3,19843,2
3972,19841,2,19843,3,19846,1
3973,19844,2,19846,3,19849,1
3974,19847,2,19849,3,19852,1
3975,19852,0,19852,3,19855,0
3976,19861,0,19861,3,19864,0
3976,19864,0,19864,3,19867,0
3977,19866,1,19867,3,19870,1
3977,19870,0,19870,3,19873,0
3978,19874,0,19874,3,19877,0
3978,19877,0,19877,3,19880,0
3979,19878,2,19880,3,19883,1
3980,19882,1,19883,3,19886,1
3981,19883,3,19886,3,19889,1
3982,19885,4,19889,3,19892,2
3980,19886,6,19892,3,19895,2
3983,19888,7,19895,3,19898,3
3980,19889,9,19898,3,19901,3
3981,19895,6,19901,3,19904,2
3984,19896,8,19904,3,19907,3
3981,19898,9,19907,3,19910,3
3981,19901,9,19910,3,19913,3
3985,19901,12,19913,3,19916,4
3986,19905,11,19916,3,19919,4
3982,19907,12,19919,3,19922,4
3982,19910,12,19922,3,19925,4
3987,19910,15,19925,3,19928,5
3982,19913,15,19928,3,19931,5
3988,19918,13,19931,3,19934,5
3989,19920,14,19934,3,19937,5
3990,19923,14,19937,3,19940,5
3991,19929,11,19940,3,19943,4
3992,19931,12,19943,3,19946,4
3988,19934,12,19946,3,19949,4
3993,19935,14,19949,3,19952,5
3990,19943,9,19952,3,19955,3
3994,19943,12,19955,3,19958,4
3991,19949,9,19958,3,19961,3
3995,19950,11,19961,3,19964,4
3996,19952,12,19964,3,19967,4
3997,19954,13,19967,3,19970,5
3993,19958,12,19970,3,19973,4
3998,19959,14,19973,3,19976,5
3999,19964,12,19976,3,19979,4
4000,19966,13,19979,3,19982,5
4001,19971,11,19982,3,19985,4
3997,19973,12,19985,3,19988,4
4002,19974,14,19988,3,19991,5
3997,19976,15,19991,3,19994,5
4003,19978,16,19994,3,19997,6
4004,19981,16,19997,3,20000,6
4005,19986,14,20000,3,20003,5
4006,19991,12,20003,3,20006,4
4007,19994,12,20006,3,20009,4
4005,20003,6,20009,3,20012,2
4008,20005,7,20012,3,20015,3
4005,20006,9,20015,3,20018,3
4005,20009,9,20018,3,20021,3
4009,20011,10,20021,3,20024,4
4006,20015,9,20024,3,20027,3
4010,20017,10,20027,3,20030,4
4011,20024,6,20030,3,20033,2
4012,20030,3,20033,3,20036,1
4013,20034,2,20036,3,20039,1
4012,20036,3,20039,3,20042,1
4013,20042,0,20042,3,20045,0
4014,20042,3,20045,3,20048,1
4015,20045,3,20048,3,20051,1
4016,20050,1,20051,3,20054,1
4015,20051,3,20054,3,20057,1
4017,20053,4,20057,3,20060,2
4016,20057,3,20060,3,20063,1
4018,20058,5,20063,3,20066,2
4019,20060,6,20066,3,20069,2
4020,20065,4,20069,3,20072,2
4020,20072,0,20072,3,20075,0
4021,20073,2,20075,3,20078,1
4022,20077,1,20078,3,20081,1
4021,20078,3,20081,3,20084,1
4021,20081,3,20084,3,20087,1
4023,20081,6,20087,3,20090,2
4021,20084,6,20090,3,20093,2
4024,20087,6,20093,3,20096,2
4023,20093,3,20096,3,20099,1
4025,20094,5,20099,3,20102,2
4026,20097,5,20102,3,20105,2
4027,20103,2,20105,3,20108,1
4026,20105,3,20108,3,20111,1
4028,20109,2,20111,3,20114,1
4029,20112,2,20114,3,20117,1
4028,20114,3,20117,3,20120,1
4028,20117,3,20120,3,20123,1
4030,20118,5,20123,3,20126,2
4031,20121,5,20126,3,20129,2
4032,20124,5,20129,3,20132,2
4033,20127,5,20132,3,20135,2
4034,20133,2,20135,3,20138,1
4033,20135,3,20138,3,20141,1
4035,20135,6,20141,3,20144,2
4034,20141,3,20144,3,20147,1
4036,20143,4,20147,3,20150,2
4037,20145,5,20150,3,20153,2
4035,20147,6,20153,3,20156,2
4038,20147,9,20156,3,20159,3
4035,20150,9,20159,3,20162,3
4039,20154,8,20162,3,20165,3
4040,20160,5,20165,3,20168,2
4041,20165,3,20168,3,20171,1
4042,20169,2,20171,3,20174,1
4043,20177,0,20177,3,20180,0
4044,20180,0,20180,3,20183,0
4045,20187,0,20187,3,20190,0
4046,20190,0,20190,3,20193,0
4047,20192,1,20193,3,20196,1
4048,20198,0,20198,3,20201,0
4049,20205,0,20205,3,20208,0
4050,20212,0,20212,3,20215,0
4050,20215,0,20215,3,20218,0
4051,20215,3,20218,3,20221,1
4050,20218,3,20221,3,20224,1
4050,20221,3,20224,3,20227,1
4052,20222,5,20227,3,20230,2
4053,20227,3,20230,3,20233,1
4052,20230,3,20233,3,20236,1
4052,20233,3,20236,3,20239,1
4054,20233,6,20239,3,20242,2
4053,20239,3,20242,3,20245,1
4055,20241,4,20245,3,20248,2
4053,20242,6,20248,3,20251,2
4056,20244,7,20251,3,20254,3
4053,20245,9,20254,3,20257,3
4057,20249,8,20257,3,20260,3
4058,20256,4,20260,3,20263,2
4059,20259,4,20263,3,20266,2
4057,20260,6,20266,3,20269,2
4060,20262,7,20269,3,20272,3
4061,20268,4,20272,3,20275,2
4059,20269,6,20275,3,20278,2
4059,20272,6,20278,3,20281,2
4062,20272,9,20281,3,20284,3
4063,20279,5,20284,3,20287,2
4061,20281,6,20287,3,20290,2
4061,20284,6,20290,3,20293,2
4064,20285,8,20293,3,20296,3
4065,20289,7,20296,3,20299,3
4066,20296,3,20299,3,20302,1
4065,20299,3,20302,3,20305,1
4067,20301,4,20305,3,20308,2
4066,20305,3,20308,3,20311,1
4068,20307,4,20311,3,20314,2
4069,20310,4,20314,3,20317,2
4068,20314,3,20317,3,20320,1
4070,20316,4,20320,3,20323,2
4071,20321,2,20323,3,20326,1
4072,20326,0,20326,3,20329,0
4072,20329,0,20329,3,20332,0
4073,20332,0,20332,3,20335,0
4074,20339,0,20339,3,20342,0
4075,20345,0,20345,3,20348,0
4076,20352,0,20352,3,20355,0
4077,20359,0,20359,3,20362,0
4078,20364,0,20364,3,20367,0
4079,20367,0,20367,3,20370,0
4080,20374,0,20374,3,20377,0
4081,20380,0,20380,3,20383,0
4082,20385,0,20385,3,20388,0
4083,20386,2,20388,3,20391,1
4082,20388,3,20391,3,20394,1
4084,20390,4,20394,3,20397,2
4082,20391,6,20397,3,20400,2
4085,20395,5,20400,3,20403,2
4086,20398,5,20403,3,20406,2
4087,20405,1,20406,3,20409,1
4087,20409,0,20409,3,20412,0
4087,20412,0,20412,3,20415,0
4088,20413,2,20415,3,20418,1
4089,20415,3,20418,3,20421,1
4090,20416,5,20421,3,20424,2
4091,20420,4,20424,3,20427,2
4092,20421,6,20427,3,20430,2
4090,20424,6,20430,3,20433,2
4093,20424,9,20433,3,20436,3
4094,20431,5,20436,3,20439,2
4095,20434,5,20439,3,20442,2
4096,20437,5,20442,3,20445,2
4097,20444,1,20445,3,20448,1
4098,20446,2,20448,3,20451,1
4098,20451,0,20451,3,20454,0
4099,20451,3,20454,3,20457,1
4100,20456,1,20457,3,20460,1
4101,20460,0,20460,3,20463,0
4102,20466,0,20466,3,20469,0
4103,20467,2,20469,3,20472,1
4104,20469,3,20472,3,20475,1
4105,20472,3,20475,3,20478,1
4106,20475,3,20478,3,20481,1
4107,20479,2,20481,3,20484,1
4108,20481,3,20484,3,20487,1
4109,20489,0,20489,3,20492,0
4109,20492,0,20492,3,20495,0
4110,20496,0,20496,3,20499,0
4111,20501,0,20501,3,20504,0
4111,20504,0,20504,3,20507,0
4112,20508,0,20508,3,20511,0
4112,20511,0,20511,3,20514,0
4112,20514,0,20514,3,20517,0
4113,20514,3,20517,3,20520,1
4112,20517,3,20520,3,20523,1
4114,20522,1,20523,3,20526,1
4115,20526,0,20526,3,20529,0
4116,20530,0,20530,3,20533,0
4117,20535,0,20535,3,20538,0
4118,20540,0,20540,3,20543,0
4118,20543,0,20543,3,20546,0
4119,20546,0,20546,3,20549,0
4120,20550,0,20550,3,20553,0
4121,20557,0,20557,3,20560,0
4121,20560,0,20560,3,20563,0
4122,20561,2,20563,3,20566,1
4123,20563,3,20566,3,20569,1
4124,20566,3,20569,3,20572,1
4125,20569,3,20572,3,20575,1
4126,20571,4,20575,3,20578,2
4127,20577,1,20578,3,20581,1
4128,20584,0,20584,3,20587,0
4129,20591,0,20591,3,20594,0
4130,20595,0,20595,3,20598,0
4130,20598,0,20598,3,20601,0
4131,20600,1,20601,3,20604,1
4130,20601,3,20604,3,20607,1
4131,20607,0,20607,3,20610,0
4132,20608,2,20610,3,20613,1
4133,20612,1,20613,3,20616,1
4132,20613,3,20616,3,20619,1
4134,20618,1,20619,3,20622,1
4134,20622,0,20622,3,20625,0
4135,20624,1,20625,3,20628,1
4136,20630,0,20630,3,20633,0
4136,20633,0,20633,3,20636,0
4137,20635,1,20636,3,20639,1
4138,20638,1,20639,3,20642,1
4139,20642,0,20642,3,20645,0
4140,20645,0,20645,3,20648,0
4141,20650,0,20650,3,20653,0
4142,20652,1,20653,3,20656,1
4143,20654,2,20656,3,20659,1
4142,20656,3,20659,3,20662,1
4142,20659,3,20662,3,20665,1
4144,20661,4,20665,3,20668,2
4145,20671,0,20671,3,20674,0
4146,20674,0,20674,3,20677,0
4146,20677,0,20677,3,20680,0
4147,20677,3,20680,3,20683,1
4146,20680,3,20683,3,20686,1
4148,20682,4,20686,3,20689,2
4147,20686,3,20689,3,20692,1
4149,20688,4,20692,3,20695,2
4147,20689,6,20695,3,20698,2
4150,20690,8,20698,3,20701,3
4151,20691,10,20701,3,20704,4
4152,20694,10,20704,3,20707,4
4148,20695,12,20707,3,20710,4
4153,20696,14,20710,3,20713,5
4149,20701,12,20713,3,20716,4
4154,20703,13,20716,3,20719,5
4155,20707,12,20719,3,20722,4
4156,20713,9,20722,3,20725,3
4157,20716,9,20725,3,20728,3
4154,20719,9,20728,3,20731,3
4158,20721,10,20731,3,20734,4
4154,20722,12,20734,3,20737,4
4154,20725,12,20737,3,20740,4
4159,20726,14,20740,3,20743,5
4156,20734,9,20743,3,20746,3
4160,20734,12,20746,3,20749,4
4158,20743,6,20749,3,20752,2
4161,20743,9,20752,3,20755,3
4158,20746,9,20755,3,20758,3
4162,20749,9,20758,3,20761,3
4163,20753,8,20761,3,20764,3
4162,20761,3,20764,3,20767,1
4164,20764,3,20767,3,20770,1
4165,20770,0,20770,3,20773,0
4165,20773,0,20773,3,20776,0
4165,20776,0,20776,3,20779,0
4166,20776,3,20779,3,20782,1
4167,20782,0,20782,3,20785,0
4168,20785,0,20785,3,20788,0
4169,20792,0,20792,3,20795,0
4170,20798,0,20798,3,20801,0
4170,20801,0,20801,3,20804,0
4171,20805,0,20805,3,20808,0
4172,20811,0,20811,3,20814,0
4173,20815,0,20815,3,20818,0
4174,20816,2,20818,3,20821,1
4174,20821,0,20821,3,20824,0
4175,20822,2,20824,3,20827,1
4176,20826,1,20827,3,20830,1
4177,20830,0,20830,3,20833,0
4177,20833,0,20833,3,20836,0
4178,20833,3,20836,3,20839,1
4179,20837,2,20839,3,20842,1
4180,20841,1,20842,3,20845,1
4181,20846,0,20846,3,20849,0
4181,20849,0,20849,3,20852,0
4182,20850,2,20852,3,20855,1
4183,20853,2,20855,3,20858,1
4184,20857,1,20858,3,20861,1
4183,20858,3,20861,3,20864,1
4185,20860,4,20864,3,20867,2
4186,20862,5,20867,3,20870,2
4187,20871,0,20871,3,20874,0
4187,20874,0,20874,3,20877,0
4188,20880,0,20880,3,20883,0
4189,20885,0,20885,3,20888,0
4190,20891,0,20891,3,20894,0
4191,20897,0,20897,3,20900,0
4191,20900,0,20900,3,20903,0
4192,20901,2,20903,3,20906,1
4193,20907,0,20907,3,20910,0
4194,20913,0,20913,3,20916,0
4195,20915,1,20916,3,20919,1
4196,20917,2,20919,3,20922,1
4197,20922,0,20922,3,20925,0
4198,20925,0,20925,3,20928,0
4199,20934,0,20934,3,20937,0
4200,20942,0,20942,3,20945,0
4201,20946,0,20946,3,20949,0
4202,20954,0,20954,3,20957,0
4202,20957,0,20957,3,20960,0
4202,20960,0,20960,3,20963,0
4203,20960,3,20963,3,20966,1
4204,20965,1,20966,3,20969,1
4203,20966,3,20969,3,20972,1
4205,20967,5,20972,3,20975,2
4206,20975,0,20975,3,20978,0
4207,20979,0,20979,3,20982,0
4208,20983,0,20983,3,20986,0
4209,20985,1,20986,3,20989,1
4210,20990,0,20990,3,20993,0
4211,20996,0,20996,3,20999,0
4212,21005,0,21005,3,21008,0
4213,21011,0,21011,3,21014,0
4214,21016,0,21016,3,21019,0
4215,21020,0,21020,3,21023,0
4215,21023,0,21023,3,21026,0
4216,21023,3,21026,3,21029,1
4217,21028,1,21029,3,21032,1
4218,21032,0,21032,3,21035,0
4219,21034,1,21035,3,21038,1
4220,21037,1,21038,3,21041,1
4219,21038,3,21041,3,21044,1
4221,21041,3,21044,3,21047,1
4220,21044,3,21047,3,21050,1
4222,21046,4,21050,3,21053,2
4223,21047,6,21053,3,21056,2
4224,21052,4,21056,3,21059,2
4222,21053,6,21059,3,21062,2
4225,21055,7,21062,3,21065,3
4226,21060,5,21065,3,21068,2
4224,21062,6,21068,3,21071,2
4227,21064,7,21071,3,21074,3
4228,21067,7,21074,3,21077,3
4229,21070,7,21077,3,21080,3
4230,21074,6,21080,3,21083,2
4231,21076,7,21083,3,21086,3
4228,21077,9,21086,3,21089,3
4232,21079,10,21089,3,21092,4
4233,21086,6,21092,3,21095,2
4231,21089,6,21095,3,21098,2
4231,21092,6,21098,3,21101,2
4234,21093,8,21101,3,21104,3
4235,21099,5,21104,3,21107,2
4233,21101,6,21107,3,21110,2
4233,21104,6,21110,3,21113,2
4236,21107,6,21113,3,21116,2
4237,21112,4,21116,3,21119,2
4235,21113,6,21119,3,21122,2
4238,21116,6,21122,3,21125,2
4236,21119,6,21125,3,21128,2
4239,21122,6,21128,3,21131,2
4240,21128,3,21131,3,21134,1
4241,21135,0,21135,3,21138,0
4241,21138,0,21138,3,21141,0
4242,21144,0,21144,3,21147,0
4243,21146,1,21147,3,21150,1
4243,21150,0,21150,3,21153,0
4244,21152,1,21153,3,21156,1
4244,21156,0,21156,3,21159,0
4245,21160,0,21160,3,21163,0
4246,21167,0,21167,3,21170,0
4247,21170,0,21170,3,21173,0
4248,21175,0,21175,3,21178,0
4249,21177,1,21178,3,21181,1
4248,21178,3,21181,3,21184,1
4250,21179,5,21184,3,21187,2
4251,21183,4,21187,3,21190,2
4249,21184,6,21190,3,21193,2
4252,21186,7,21193,3,21196,3
4253,21191,5,21196,3,21199,2
4251,21193,6,21199,3,21202,2
4254,21194,8,21202,3,21205,3
4255,21196,9,21205,3,21208,3
4256,21201,7,21208,3,21211,3
4257,21205,6,21211,3,21214,2
4255,21208,6,21214,3,21217,2
4258,21209,8,21217,3,21220,3
4255,21211,9,21220,3,21223,3
4259,21213,10,21223,3,21226,4
4256,21217,9,21226,3,21229,3
4256,21220,9,21229,3,21232,3
4260,21221,11,21232,3,21235,4
4256,21223,12,21235,3,21238,4
4261,21230,8,21238,3,21241,3
4262,21237,4,21241,3,21244,2
4260,21238,6,21244,3,21247,2
4263,21238,9,21247,3,21250,3
4261,21244,6,21250,3,21253,2
4264,21245,8,21253,3,21256,3
4265,21253,3,21256,3,21259,1
4264,21256,3,21259,3,21262,1
4266,21262,0,21262,3,21265,0
4266,21265,0,21265,3,21268,0
4267,21275,0,21275,3,21278,0
4268,21283,0,21283,3,21286,0
4269,21286,0,21286,3,21289,0
4270,21291,0,21291,3,21294,0
4271,21295,0,21295,3,21298,0
4272,21299,0,21299,3,21302,0
4272,21302,0,21302,3,21305,0
4273,21302,3,21305,3,21308,1
4274,21305,3,21308,3,21311,1
4274,21311,0,21311,3,21314,0
4275,21311,3,21314,3,21317,1
4276,21312,5,21317,3,21320,2
4277,21316,4,21320,3,21323,2
4278,21318,5,21323,3,21326,2
4276,21320,6,21326,3,21329,2
4277,21326,3,21329,3,21332,1
4279,21328,4,21332,3,21335,2
4280,21332,3,21335,3,21338,1
4281,21334,4,21338,3,21341,2
4279,21335,6,21341,3,21344,2
4282,21339,5,21344,3,21347,2
4280,21341,6,21347,3,21350,2
4283,21345,5,21350,3,21353,2
4284,21348,5,21353,3,21356,2
4285,21352,4,21356,3,21359,2
4283,21353,6,21359,3,21362,2
4283,21356,6,21362,3,21365,2
4286,21357,8,21365,3,21368,3
4284,21362,6,21368,3,21371,2
4287,21362,9,21371,3,21374,3
4284,21365,9,21374,3,21377,3
4288,21370,7,21377,3,21380,3
4289,21372,8,21380,3,21383,3
4290,21377,6,21383,3,21386,2
4291,21384,2,21386,3,21389,1
4292,21385,4,21389,3,21392,2
4293,21389,3,21392,3,21395,1
4294,21395,0,21395,3,21398,0
4295,21403,0,21403,3,21406,0
4295,21406,0,21406,3,21409,0
4295,21409,0,21409,3,21412,0
4296,21409,3,21412,3,21415,1
4297,21410,5,21415,3,21418,2
4295,21412,6,21418,3,21421,2
4298,21412,9,21421,3,21424,3
4299,21417,7,21424,3,21427,3
4298,21424,3,21427,3,21430,1
4300,21425,5,21430,3,21433,2
4298,21427,6,21433,3,21436,2
4298,21430,6,21436,3,21439,2
4301,21430,9,21439,3,21442,3
4298,21433,9,21442,3,21445,3
4302,21433,12,21445,3,21448,4
4303,21436,12,21448,3,21451,4
4299,21439,12,21451,3,21454,4
4304,21441,13,21454,3,21457,5
4300,21445,12,21457,3,21460,4
4305,21448,12,21460,3,21463,4
4302,21454,9,21463,3,21466,3
4306,21454,12,21466,3,21469,4
4307,21456,13,21469,3,21472,5
4305,21466,6,21472,3,21475,2
4308,21466,9,21475,3,21478,3
4309,21469,9,21478,3,21481,3
4310,21471,10,21481,3,21484,4
4311,21477,7,21484,3,21487,3
4308,21478,9,21487,3,21490,3
4312,21479,11,21490,3,21493,4
4313,21483,10,21493,3,21496,4
4310,21487,9,21496,3,21499,3
4314,21488,11,21499,3,21502,4
4315,21491,11,21502,3,21505,4
4316,21494,11,21505,3,21508,4
4312,21496,12,21508,3,21511,4
4317,21499,12,21511,3,21514,4
4318,21503,11,21514,3,21517,4
4319,21507,10,21517,3,21520,4
4320,21511,9,21520,3,21523,3
4321,21512,11,21523,3,21526,4
4322,21516,10,21526,3,21529,4
4323,21519,10,21529,3,21532,4
4319,21520,12,21532,3,21535,4
4319,21523,12,21535,3,21538,4
4324,21524,14,21538,3,21541,5
4325,21527,14,21541,3,21544,5
4326,21531,13,21544,3,21547,5
4327,21533,14,21547,3,21550,5
4328,21540,10,21550,3,21553,4
4329,21544,9,21553,3,21556,3
4330,21547,9,21556,3,21559,3
4327,21550,9,21559,3,21562,3
4331,21552,10,21562,3,21565,4
4332,21555,10,21565,3,21568,4
4333,21562,6,21568,3,21571,2
4334,21567,4,21571,3,21574,2
4332,21568,6,21574,3,21577,2
4335,21572,5,21577,3,21580,2
4333,21574,6,21580,3,21583,2
4336,21576,7,21583,3,21586,3
4337,21579,7,21586,3,21589,3
4338,21585,4,21589,3,21592,2
4339,21589,3,21592,3,21595,1
4340,21597,0,21597,3,21600,0
4340,21600,0,21600,3,21603,0
4341,21604,0,21604,3,21607,0
4342,21608,0,21608,3,21611,0
4342,21611,0,21611,3,21614,0
4343,21617,0,21617,3,21620,0
4344,21621,0,21621,3,21624,0
4345,21626,0,21626,3,21629,0
4346,21635,0,21635,3,21638,0
4347,21643,0,21643,3,21646,0
4348,21646,0,21646,3,21649,0
4348,21649,0,21649,3,21652,0
4349,21651,1,21652,3,21655,1
4350,21657,0,21657,3,21660,0
4351,21660,0,21660,3,21663,0
4351,21663,0,21663,3,21666,0
4352,21664,2,21666,3,21669,1
4352,21669,0,21669,3,21672,0
4353,21669,3,21672,3,21675,1
4354,21674,1,21675,3,21678,1
4355,21677,1,21678,3,21681,1
4356,21685,0,21685,3,21688,0
4357,21689,0,21689,3,21692,0
4358,21694,0,21694,3,21697,0
4359,21700,0,21700,3,21703,0
4359,21703,0,21703,3,21706,0
4359,21706,0,21706,3,21709,0
4360,21706,3,21709,3,21712,1
4361,21709,3,21712,3,21715,1
4361,21715,0,21715,3,21718,0
4362,21715,3,21718,3,21721,1
4363,21716,5,21721,3,21724,2
4361,21718,6,21724,3,21727,2
4364,21718,9,21727,3,21730,3
4365,21720,10,21730,3,21733,4
4362,21724,9,21733,3,21736,3
4366,21725,11,21736,3,21739,4
4363,21730,9,21739,3,21742,3
4364,21736,6,21742,3,21745,2
4367,21737,8,21745,3,21748,3
4368,21743,5,21748,3,21751,2
4369,21746,5,21751,3,21754,2
4370,21750,4,21754,3,21757,2
4368,21751,6,21757,3,21760,2
4371,21755,5,21760,3,21763,2
4372,21758,5,21763,3,21766,2
4370,21760,6,21766,3,21769,2
4373,21764,5,21769,3,21772,2
4372,21769,3,21772,3,21775,1
4372,21772,3,21775,3,21778,1
4374,21773,5,21778,3,21781,2
4375,21776,5,21781,3,21784,2
4376,21779,5,21784,3,21787,2
4377,21786,1,21787,3,21790,1
4376,21787,3,21790,3,21793,1
4378,21790,3,21793,3,21796,1
4379,21791,5,21796,3,21799,2
4380,21795,4,21799,3,21802,2
4381,21799,3,21802,3,21805,1
4382,21802,3,21805,3,21808,1
4381,21805,3,21808,3,21811,1
4383,21805,6,21811,3,21814,2
4381,21808,6,21814,3,21817,2
4384,21811,6,21817,3,21820,2
4385,21813,7,21820,3,21823,3
4386,21815,8,21823,3,21826,3
4387,21821,5,21826,3,21829,2
4387,21829,0,21829,3,21832,0
4388,21830,2,21832,3,21835,1
4389,21834,1,21835,3,21838,1
4390,21838,0,21838,3,21841,0
4390,21841,0,21841,3,21844,0
4391,21844,0,21844,3,21847,0
4391,21847,0,21847,3,21850,0
4392,21848,2,21850,3,21853,1
4392,21853,0,21853,3,21856,0
4393,21854,2,21856,3,21859,1
4392,21856,3,21859,3,21862,1
4394,21859,3,21862,3,21865,1
4395,21868,0,21868,3,21871,0
4396,21872,0,21872,3,21875,0
4396,21875,0,21875,3,21878,0
4397,21878,0,21878,3,21881,0
4398,21885,0,21885,3,21888,0
4399,21893,0,21893,3,21896,0
4400,21896,0,21896,3,21899,0
4401,21903,0,21903,3,21906,0
4401,21906,0,21906,3,21909,0
4402,21907,2,21909,3,21912,1
4403,21912,0,21912,3,21915,0
4404,21917,0,21917,3,21920,0
4405,21922,0,21922,3,21925,0
4406,21926,0,21926,3,21929,0
4406,21929,0,21929,3,21932,0
4407,21930,2,21932,3,21935,1
4407,21935,0,21935,3,21938,0
4408,21943,0,21943,3,21946,0
4409,21949,0,21949,3,21952,0
4410,21952,0,21952,3,21955,0
4410,21955,0,21955,3,21958,0
4410,21958,0,21958,3,21961,0
4411,21960,1,21961,3,21964,1
4410,21961,3,21964,3,21967,1
4410,21964,3,21967,3,21970,1
4412,21968,2,21970,3,21973,1
4413,21974,0,21974,3,21977,0
4414,21978,0,21978,3,21981,0
4415,21979,2,21981,3,21984,1
4415,21984,0,21984,3,21987,0
4416,21984,3,21987,3,21990,1
4417,21989,1,21990,3,21993,1
4416,21990,3,21993,3,21996,1
4416,21993,3,21996,3,21999,1
4418,21996,3,21999,3,22002,1
4419,21998,4,22002,3,22005,2
4420,22008,0,22008,3,22011,0
4421,22013,0,22013,3,22016,0
4422,22014,2,22016,3,22019,1
4423,22016,3,22019,3,22022,1
4424,22021,1,22022,3,22025,1
4424,22025,0,22025,3,22028,0
4425,22026,2,22028,3,22031,1
4426,22031,0,22031,3,22034,0
4427,22044,0,22044,3,22047,0
4428,22048,0,22048,3,22051,0
4428,22051,0,22051,3,22054,0
4429,22052,2,22054,3,22057,1
4428,22054,3,22057,3,22060,1
4430,22055,5,22060,3,22063,2
4431,22059,4,22063,3,22066,2
4432,22064,2,22066,3,22069,1
4433,22068,1,22069,3,22072,1
4432,22069,3,22072,3,22075,1
4432,22072,3,22075,3,22078,1
4434,22072,6,22078,3,22081,2
4433,22078,3,22081,3,22084,1
4435,22078,6,22084,3,22087,2
4436,22082,5,22087,3,22090,2
4434,22084,6,22090,3,22093,2
4437,22086,7,22093,3,22096,3
4434,22087,9,22096,3,22099,3
4438,22091,8,22099,3,22102,3
4436,22096,6,22102,3,22105,2
4439,22098,7,22105,3,22108,3
4440,22102,6,22108,3,22111,2
4438,22105,6,22111,3,22114,2
4441,22107,7,22114,3,22117,3
4442,22110,7,22117,3,22120,3
4443,22114,6,22120,3,22123,2
4444,22116,7,22123,3,22126,3
4445,22122,4,22126,3,22129,2
4443,22123,6,22129,3,22132,2
4446,22124,8,22132,3,22135,3
4447,22126,9,22135,3,22138,3
4448,22132,6,22138,3,22141,2
4449,22135,6,22141,3,22144,2
4450,22137,7,22144,3,22147,3
4451,22139,8,22147,3,22150,3
4452,22144,6,22150,3,22153,2
4450,22147,6,22153,3,22156,2
4453,22147,9,22156,3,22159,3
4454,22152,7,22159,3,22162,3
4452,22156,6,22162,3,22165,2
4455,22156,9,22165,3,22168,3
4456,22163,5,22168,3,22171,2
4454,22165,6,22171,3,22174,2
4455,22171,3,22174,3,22177,1
4457,22174,3,22177,3,22180,1
4456,22177,3,22180,3,22183,1
4458,22178,5,22183,3,22186,2
4459,22179,7,22186,3,22189,3
4456,22180,9,22189,3,22192,3
4460,22185,7,22192,3,22195,3
4461,22191,4,22195,3,22198,2
4459,22192,6,22198,3,22201,2
4462,22194,7,22201,3,22204,3
4459,22195,9,22204,3,22207,3
4460,22201,6,22207,3,22210,2
4463,22203,7,22210,3,22213,3
4460,22204,9,22213,3,22216,3
4464,22209,7,22216,3,22219,3
4465,22216,3,22219,3,22222,1
4465,22222,0,22222,3,22225,0
4466,22224,1,22225,3,22228,1
4465,22225,3,22228,3,22231,1
4467,22227,4,22231,3,22234,2
4468,22231,3,22234,3,22237,1
4469,22238,0,22238,3,22241,0
4470,22241,0,22241,3,22244,0
4471,22247,0,22247,3,22250,0
4471,22250,0,22250,3,22253,0
4472,22250,3,22253,3,22256,1
4471,22253,3,22256,3,22259,1
4473,22255,4,22259,3,22262,2
4474,22263,0,22263,3,22266,0
4475,22267,0,22267,3,22270,0
4476,22269,1,22270,3,22273,1
4475,22270,3,22273,3,22276,1
4477,22273,3,22276,3,22279,1
4476,22276,3,22279,3,22282,1
4478,22278,4,22282,3,22285,2
4478,22285,0,22285,3,22288,0
4479,22287,1,22288,3,22291,1
4480,22290,1,22291,3,22294,1
4481,22296,0,22296,3,22299,0
4482,22300,0,22300,3,22303,0
4483,22304,0,22304,3,22307,0
4484,22317,0,22317,3,22320,0
4485,22323,0,22323,3,22326,0
4485,22326,0,22326,3,22329,0
4486,22332,0,22332,3,22335,0
4487,22338,0,22338,3,22341,0
4488,22345,0,22345,3,22348,0
4488,22348,0,22348,3,22351,0
4489,22349,2,22351,3,22354,1
4488,22351,3,22354,3,22357,1
4490,22359,0,22359,3,22362,0
4491,22363,0,22363,3,22366,0
4492,22370,0,22370,3,22373,0
4493,22373,0,22373,3,22376,0
4494,22377,0,22377,3,22380,0
4495,22383,0,22383,3,22386,0
4496,22387,0,22387,3,22390,0
4496,22390,0,22390,3,22393,0
4497,22393,0,22393,3,22396,0
4497,22396,0,22396,3,22399,0
4498,22405,0,22405,3,22408,0
4499,22413,0,22413,3,22416,0
4500,22417,0,22417,3,22420,0
4501,22423,0,22423,3,22426,0
4502,22425,1,22426,3,22429,1
4501,22426,3,22429,3,22432,1
4503,22429,3,22432,3,22435,1
4504,22433,2,22435,3,22438,1
4503,22435,3,22438,3,22441,1
4503,22438,3,22441,3,22444,1
4505,22438,6,22444,3,22447,2
4506,22443,4,22447,3,22450,2
4507,22444,6,22450,3,22453,2
4508,22444,9,22453,3,22456,3
4505,22447,9,22456,3,22459,3
4509,22447,12,22459,3,22462,4
4510,22453,9,22462,3,22465,3
4507,22456,9,22465,3,22468,3
4507,22459,9,22468,3,22471,3
4511,22459,12,22471,3,22474,4
4512,22464,10,22474,3,22477,4
4508,22465,12,22477,3,22480,4
4513,22468,12,22480,3,22483,4
4514,22471,12,22483,3,22486,4
4515,22475,11,22486,3,22489,4
4511,22477,12,22489,3,22492,4
4516,22478,14,22492,3,22495,5
4517,22484,11,22495,3,22498,4
4518,22490,8,22498,3,22501,3
4519,22495,6,22501,3,22504,2
4517,22498,6,22504,3,22507,2
4520,22500,7,22507,3,22510,3
4521,22503,7,22510,3,22513,3
4519,22507,6,22513,3,22516,2
4522,22507,9,22516,3,22519,3
4523,22513,6,22519,3,22522,2
4524,22519,3,22522,3,22525,1
4525,22520,5,22525,3,22528,2
4523,22522,6,22528,3,22531,2
4525,22531,0,22531,3,22534,0
4526,22531,3,22534,3,22537,1
4527,22539,0,22539,3,22542,0
4528,22545,0,22545,3,22548,0
4528,22548,0,22548,3,22551,0
4529,22549,2,22551,3,22554,1
4530,22561,0,22561,3,22564,0
4531,22566,0,22566,3,22569,0
4532,22574,0,22574,3,22577,0
4533,22575,2,22577,3,22580,1
4533,22580,0,22580,3,22583,0
4534,22581,2,22583,3,22586,1
4533,22583,3,22586,3,22589,1
4533,22586,3,22589,3,22592,1
4535,22587,5,22592,3,22595,2
4536,22588,7,22595,3,22598,3
4537,22591,7,22598,3,22601,3
4534,22592,9,22601,3,22604,3
4534,22595,9,22604,3,22607,3
4538,22596,11,22607,3,22610,4
4534,22598,12,22610,3,22613,4
4539,22599,14,22613,3,22616,5
4540,22601,15,22616,3,22619,5
4541,22605,14,22619,3,22622,5
4542,22614,8,22622,3,22625,3
4539,22616,9,22625,3,22628,3
4543,22618,10,22628,3,22631,4
4539,22619,12,22631,3,22634,4
4544,22627,7,22634,3,22637,3
4541,22628,9,22637,3,22640,3
4541,22631,9,22640,3,22643,3
4545,22632,11,22643,3,22646,4
4546,22637,9,22646,3,22649,3
4547,22642,7,22649,3,22652,3
4544,22643,9,22652,3,22655,3
4544,22646,9,22655,3,22658,3
4548,22649,9,22658,3,22661,3
4545,22652,9,22661,3,22664,3
4549,22654,10,22664,3,22667,4
4546,22658,9,22667,3,22670,3
4550,22660,10,22670,3,22673,4
4546,22661,12,22673,3,22676,4
4546,22664,12,22676,3,22679,4
4546,22667,12,22679,3,22682,4
4551,22670,12,22682,3,22685,4
4552,22678,7,22685,3,22688,3
4553,22684,4,22688,3,22691,2
4552,22688,3,22691,3,22694,1
4552,22691,3,22694,3,22697,1
4554,22691,6,22697,3,22700,2
4555,22698,2,22700,3,22703,1
4554,22700,3,22703,3,22706,1
4555,22706,0,22706,3,22709,0
4556,22710,0,22710,3,22713,0
4557,22716,0,22716,3,22719,0
4557,22719,0,22719,3,22722,0
4558,22721,1,22722,3,22725,1
4559,22723,2,22725,3,22728,1
4560,22728,0,22728,3,22731,0
4561,22737,0,22737,3,22740,0
4561,22740,0,22740,3,22743,0
4562,22741,2,22743,3,22746,1
4563,22745,1,22746,3,22749,1
4564,22757,0,22757,3,22760,0
4565,22763,0,22763,3,22766,0
4565,22766,0,22766,3,22769,0
4565,22769,0,22769,3,22772,0
4566,22770,2,22772,3,22775,1
4565,22772,3,22775,3,22778,1
4567,22776,2,22778,3,22781,1
4568,22781,0,22781,3,22784,0
4569,22783,1,22784,3,22787,1
4569,22787,0,22787,3,22790,0
4570,22789,1,22790,3,22793,1
4569,22790,3,22793,3,22796,1
4571,22793,3,22796,3,22799,1
4572,22795,4,22799,3,22802,2
4573,22802,0,22802,3,22805,0
4574,22812,0,22812,3,22815,0
4575,22815,0,22815,3,22818,0
4576,22819,0,22819,3,22822,0
4577,22825,0,22825,3,22828,0
4578,22832,0,22832,3,22835,0
4579,22839,0,22839,3,22842,0
4580,22841,1,22842,3,22845,1
4581,22845,0,22845,3,22848,0
4582,22853,0,22853,3,22856,0
4583,22859,0,22859,3,22862,0
4583,22862,0,22862,3,22865,0
4584,22865,0,22865,3,22868,0
4585,22867,1,22868,3,22871,1
4586,22877,0,22877,3,22880,0
4587,22886,0,22886,3,22889,0
4587,22889,0,22889,3,22892,0
4588,22889,3,22892,3,22895,1
4589,22896,0,22896,3,22899,0
4590,22899,0,22899,3,22902,0
4590,22902,0,22902,3,22905,0
4591,22903,2,22905,3,22908,1
4592,22908,0,22908,3,22911,0
4593,22912,0,22912,3,22915,0
4594,22919,0,22919,3,22922,0
4595,22921,1,22922,3,22925,1
4596,22933,0,22933,3,22936,0
4597,22940,0,22940,3,22943,0
4598,22945,0,22945,3,22948,0
4598,22948,0,22948,3,22951,0
4598,22951,0,22951,3,22954,0
4599,22953,1,22954,3,22957,1
4600,22959,0,22959,3,22962,0
4601,22965,0,22965,3,22968,0
4602,22969,0,22969,3,22972,0
4602,22972,0,22972,3,22975,0
4602,22975,0,22975,3,22978,0
4603,22976,2,22978,3,22981,1
4604,22979,2,22981,3,22984,1
4603,22981,3,22984,3,22987,1
4605,22981,6,22987,3,22990,2
4606,22984,6,22990,3,22993,2
4607,22986,7,22993,3,22996,3
4605,22990,6,22996,3,22999,2
4608,22990,9,22999,3,23002,3
4609,22996,6,23002,3,23005,2
4607,22999,6,23005,3,23008,2
4610,23006,2,23008,3,23011,1
4611,23013,0,23013,3,23016,0
4612,23018,0,23018,3,23021,0
4612,23021,0,23021,3,23024,0
4613,23021,3,23024,3,23027,1
4614,23029,0,23029,3,23032,0
4615,23033,0,23033,3,23036,0
4615,23036,0,23036,3,23039,0
4616,23036,3,23039,3,23042,1
4615,23039,3,23042,3,23045,1
4617,23042,3,23045,3,23048,1
4618,23046,2,23048,3,23051,1
4619,23049,2,23051,3,23054,1
4620,23058,0,23058,3,23061,0
4621,23060,1,23061,3,23064,1
4620,23061,3,23064,3,23067,1
4622,23066,1,23067,3,23070,1
4623,23071,0,23071,3,23074,0
4624,23079,0,23079,3,23082,0
4625,23082,0,23082,3,23085,0
4626,23085,0,23085,3,23088,0
4627,23089,0,23089,3,23092,0
4627,23092,0,23092,3,23095,0
4628,23094,1,23095,3,23098,1
4628,23098,0,23098,3,23101,0
4629,23100,1,23101,3,23104,1
4628,23101,3,23104,3,23107,1
4630,23105,2,23107,3,23110,1
4630,23110,0,23110,3,23113,0
4631,23112,1,23113,3,23116,1
4632,23114,2,23116,3,23119,1
4633,23121,0,23121,3,23124,0
4633,23124,0,23124,3,23127,0
4634,23125,2,23127,3,23130,1
4634,23130,0,23130,3,23133,0
4635,23130,3,23133,3,23136,1
4634,23133,3,23136,3,23139,1
4636,23133,6,23139,3,23142,2
4634,23136,6,23142,3,23145,2
4637,23137,8,23145,3,23148,3
4634,23139,9,23148,3,23151,3
4638,23141,10,23151,3,23154,4
4634,23142,12,23154,3,23157,4
4639,23145,12,23157,3,23160,4
4635,23148,12,23160,3,23163,4
4640,23149,14,23163,3,23166,5
4641,23154,12,23166,3,23169,4
4642,23158,11,23169,3,23172,4
4643,23161,11,23172,3,23175,4
4644,23163,12,23175,3,23178,4
4640,23166,12,23178,3,23181,4
4645,23167,14,23181,3,23184,5
4646,23170,14,23184,3,23187,5
4647,23175,12,23187,3,23190,4
4648,23180,10,23190,3,23193,4
4646,23187,6,23193,3,23196,2
4649,23187,9,23196,3,23199,3
4650,23191,8,23199,3,23202,3
4651,23194,8,23202,3,23205,3
4648,23196,9,23205,3,23208,3
4652,23197,11,23208,3,23211,4
4653,23203,8,23211,3,23214,3
4650,23205,9,23214,3,23217,3
4650,23208,9,23217,3,23220,3
4650,23211,9,23220,3,23223,3
4654,23214,9,23223,3,23226,3
4655,23216,10,23226,3,23229,4
4656,23220,9,23229,3,23232,3
4657,23224,8,23232,3,23235,3
4658,23227,8,23235,3,23238,3
4659,23231,7,23238,3,23241,3
4660,23237,4,23241,3,23244,2
4659,23241,3,23244,3,23247,1
4661,23242,5,23247,3,23250,2
4659,23244,6,23250,3,23253,2
4662,23245,8,23253,3,23256,3
4660,23250,6,23256,3,23259,2
4663,23250,9,23259,3,23262,3
4660,23253,9,23262,3,23265,3
4664,23255,10,23265,3,23268,4
4665,23258,10,23268,3,23271,4
4666,23264,7,23271,3,23274,3
4667,23266,8,23274,3,23277,3
4664,23268,9,23277,3,23280,3
4668,23273,7,23280,3,23283,3
4669,23278,5,23283,3,23286,2
4670,23280,6,23286,3,23289,2
4668,23283,6,23289,3,23292,2
4671,23289,3,23292,3,23295,1
4670,23292,3,23295,3,23298,1
4672,23294,4,23298,3,23301,2
4673,23296,5,23301,3,23304,2
4674,23299,5,23304,3,23307,2
4672,23301,6,23307,3,23310,2
4675,23306,4,23310,3,23313,2
4676,23310,3,23313,3,23316,1
4676,23316,0,23316,3,23319,0
4677,23316,3,23319,3,23322,1
4678,23320,2,23322,3,23325,1
4678,23325,0,23325,3,23328,0
4679,23328,0,23328,3,23331,0
4680,23332,0,23332,3,23335,0
4681,23337,0,23337,3,23340,0
4681,23340,0,23340,3,23343,0
4682,23344,0,23344,3,23347,0
4682,23347,0,23347,3,23350,0
4683,23349,1,23350,3,23353,1
4682,23350,3,23353,3,23356,1
4684,23361,0,23361,3,23364,0
4684,23364,0,23364,3,23367,0
4685,23366,1,23367,3,23370,1
4686,23371,0,23371,3,23374,0
4687,23377,0,23377,3,23380,0
4688,23381,0,23381,3,23384,0
4689,23383,1,23384,3,23387,1
4689,23387,0,23387,3,23390,0
4690,23389,1,23390,3,23393,1
4689,23390,3,23393,3,23396,1
4691,23392,4,23396,3,23399,2
4692,23398,1,23399,3,23402,1
4693,23403,0,23403,3,23406,0
4694,23405,1,23406,3,23409,1
4693,23406,3,23409,3,23412,1
4693,23409,3,23412,3,23415,1
4695,23413,2,23415,3,23418,1
4696,23415,3,23418,3,23421,1
4697,23424,0,23424,3,23427,0
4697,23427,0,23427,3,23430,0
4697,23430,0,23430,3,23433,0
4698,23431,2,23433,3,23436,1
4699,23438,0,23438,3,23441,0
4700,23443,0,23443,3,23446,0
4700,23446,0,23446,3,23449,0
4701,23450,0,23450,3,23453,0
4702,23459,0,23459,3,23462,0
4703,23461,1,23462,3,23465,1
4704,23470,0,23470,3,23473,0
4705,23478,0,23478,3,23481,0
4706,23485,0,23485,3,23488,0
4707,23491,0,23491,3,23494,0
4708,23497,0,23497,3,23500,0
4709,23507,0,23507,3,23510,0
4710,23511,0,23511,3,23514,0
4711,23520,0,23520,3,23523,0
4712,23524,0,23524,3,23527,0
4712,23527,0,23527,3,23530,0
4713,23528,2,23530,3,23533,1
4714,23530,3,23533,3,23536,1
4715,23535,1,23536,3,23539,1
4714,23536,3,23539,3,23542,1
4714,23539,3,23542,3,23545,1
4716,23542,3,23545,3,23548,1
4717,23543,5,23548,3,23551,2
4715,23545,6,23551,3,23554,2
4718,23550,4,23554,3,23557,2
4716,23551,6,23557,3,23560,2
4719,23555,5,23560,3,23563,2
4720,23559,4,23563,3,23566,2
4721,23564,2,23566,3,23569,1
4722,23568,1,23569,3,23572,1
4722,23572,0,23572,3,23575,0
4723,23573,2,23575,3,23578,1
4724,23584,0,23584,3,23587,0
4724,23587,0,23587,3,23590,0
4725,23589,1,23590,3,23593,1
4726,23591,2,23593,3,23596,1
4727,23594,2,23596,3,23599,1
4728,23595,4,23599,3,23602,2
4726,23596,6,23602,3,23605,2
4726,23599,6,23605,3,23608,2
4729,23599,9,23608,3,23611,3
4730,23601,10,23611,3,23614,4
4731,23603,11,23614,3,23617,4
4732,23608,9,23617,3,23620,3
4733,23613,7,23620,3,23623,3
4734,23620,3,23623,3,23626,1
4735,23623,3,23626,3,23629,1
4736,23630,0,23630,3,23633,0
4737,23638,0,23638,3,23641,0
4738,23641,0,23641,3,23644,0
4739,23643,1,23644,3,23647,1
4740,23650,0,23650,3,23653,0
4741,23661,0,23661,3,23664,0
4742,23665,0,23665,3,23668,0
4743,23673,0,23673,3,23676,0
4744,23678,0,23678,3,23681,0
4745,23680,1,23681,3,23684,1
4746,23688,0,23688,3,23691,0
4747,23694,0,23694,3,23697,0
4747,23697,0,23697,3,23700,0
4748,23702,0,23702,3,23705,0
4749,23705,0,23705,3,23708,0
4749,23708,0,23708,3,23711,0
4750,23713,0,23713,3,23716,0
4751,23716,0,23716,3,23719,0
4752,23721,0,23721,3,23724,0
4753,23726,0,23726,3,23729,0
4754,23739,0,23739,3,23742,0
4754,23742,0,23742,3,23745,0
4755,23745,0,23745,3,23748,0
4756,23748,0,23748,3,23751,0
4757,23753,0,23753,3,23756,0
4758,23754,2,23756,3,23759,1
4759,23755,4,23759,3,23762,2
4757,23756,6,23762,3,23765,2
4760,23759,6,23765,3,23768,2
4761,23761,7,23768,3,23771,3
4758,23762,9,23771,3,23774,3
4762,23763,11,23774,3,23777,4
4763,23767,10,23777,3,23780,4
4764,23772,8,23780,3,23783,3
4765,23775,8,23783,3,23786,3
4762,23777,9,23786,3,23789,3
4766,23778,11,23789,3,23792,4
4767,23783,9,23792,3,23795,3
4768,23786,9,23795,3,23798,3
4766,23792,6,23798,3,23801,2
4769,23794,7,23801,3,23804,3
4770,23801,3,23804,3,23807,1
4771,23808,0,23808,3,23811,0
4772,23815,0,23815,3,23818,0
4773,23820,0,23820,3,23823,0
4774,23825,0,23825,3,23828,0
4775,23832,0,23832,3,23835,0
4775,23835,0,23835,3,23838,0
4776,23840,0,23840,3,23843,0
4777,23846,0,23846,3,23849,0
4777,23849,0,23849,3,23852,0
4778,23851,1,23852,3,23855,1
4779,23857,0,23857,3,23860,0
4780,23861,0,23861,3,23864,0
4781,23864,0,23864,3,23867,0
4782,23870,0,23870,3,23873,0
4782,23873,0,23873,3,23876,0
4783,23875,1,23876,3,23879,1
4782,23876,3,23879,3,23882,1
4782,23879,3,23882,3,23885,1
4784,23879,6,23885,3,23888,2
4785,23884,4,23888,3,23891,2
4783,23885,6,23891,3,23894,2
4786,23888,6,23894,3,23897,2
4784,23891,6,23897,3,23900,2
4787,23894,6,23900,3,23903,2
4788,23899,4,23903,3,23906,2
4786,23900,6,23906,3,23909,2
4786,23903,6,23909,3,23912,2
4789,23907,5,23912,3,23915,2
4788,23912,3,23915,3,23918,1
4790,23912,6,23918,3,23921,2
4791,23918,3,23921,3,23924,1
4791,23924,0,23924,3,23927,0
4792,23926,1,23927,3,23930,1
4791,23927,3,23930,3,23933,1
4793,23933,0,23933,3,23936,0
4793,23936,0,23936,3,23939,0
4794,23940,0,23940,3,23943,0
4795,23945,0,23945,3,23948,0
4796,23948,0,23948,3,23951,0
4797,23953,0,23953,3,23956,0
4798,23958,0,23958,3,23961,0
4798,23961,0,23961,3,23964,0
4799,23967,0,23967,3,23970,0
4800,23975,0,23975,3,23978,0
4801,23977,1,23978,3,23981,1
4800,23978,3,23981,3,23984,1
4802,23979,5,23984,3,23987,2
4801,23984,3,23987,3,23990,1
4803,23986,4,23990,3,23993,2
4801,23987,6,23993,3,23996,2
4804,23990,6,23996,3,23999,2
4805,23993,6,23999,3,24002,2
4806,23997,5,24002,3,24005,2
4807,24000,5,24005,3,24008,2
4805,24002,6,24008,3,24011,2
4808,24005,6,24011,3,24014,2
4809,24007,7,24014,3,24017,3
4807,24011,6,24017,3,24020,2
4810,24014,6,24020,3,24023,2
4811,24019,4,24023,3,24026,2
4810,24023,3,24026,3,24029,1
4812,24024,5,24029,3,24032,2
4810,24026,6,24032,3,24035,2
4810,24029,6,24035,3,24038,2
4813,24030,8,24038,3,24041,3
4814,24036,5,24041,3,24044,2
4815,24041,3,24044,3,24047,1
4816,24044,3,24047,3,24050,1
4817,24048,2,24050,3,24053,1
4816,24050,3,24053,3,24056,1
4818,24057,0,24057,3,24060,0
4819,24063,0,24063,3,24066,0
4820,24068,0,24068,3,24071,0
4821,24074,0,24074,3,24077,0
4822,24080,0,24080,3,24083,0
4823,24084,0,24084,3,24087,0
4824,24094,0,24094,3,24097,0
4825,24100,0,24100,3,24103,0
4826,24105,0,24105,3,24108,0
4827,24109,0,24109,3,24112,0
4828,24113,0,24113,3,24116,0
4829,24120,0,24120,3,24123,0
4830,24124,0,24124,3,24127,0
4831,24132,0,24132,3,24135,0
4831,24135,0,24135,3,24138,0
4832,24140,0,24140,3,24143,0
4833,24142,1,24143,3,24146,1
4834,24144,2,24146,3,24149,1
4835,24148,1,24149,3,24152,1
4836,24152,0,24152,3,24155,0
4836,24155,0,24155,3,24158,0
4837,24156,2,24158,3,24161,1
4836,24158,3,24161,3,24164,1
4838,24161,3,24164,3,24167,1
4839,24166,1,24167,3,24170,1
4840,24172,0,24172,3,24175,0
4840,24175,0,24175,3,24178,0
4841,24176,2,24178,3,24181,1
4842,24184,0,24184,3,24187,0
4843,24186,1,24187,3,24190,1
4844,24188,2,24190,3,24193,1
4845,24189,4,24193,3,24196,2
4843,24190,6,24196,3,24199,2
4846,24192,7,24199,3,24202,3
4847,24195,7,24202,3,24205,3
4848,24200,5,24205,3,24208,2
4849,24205,3,24208,3,24211,1
4849,24211,0,24211,3,24214,0
4850,24211,3,24214,3,24217,1
4851,24221,0,24221,3,24224,0
4852,24228,0,24228,3,24231,0
4853,24230,1,24231,3,24234,1
4854,24236,0,24236,3,24239,0
4855,24244,0,24244,3,24247,0
4856,24248,0,24248,3,24251,0
4857,24256,0,24256,3,24259,0
4858,24257,2,24259,3,24262,1
4859,24262,0,24262,3,24265,0
4859,24265,0,24265,3,24268,0
4859,24268,0,24268,3,24271,0
4860,24269,2,24271,3,24274,1
4860,24274,0,24274,3,24277,0
4861,24274,3,24277,3,24280,1
4862,24278,2,24280,3,24283,1
4862,24283,0,24283,3,24286,0
4863,24285,1,24286,3,24289,1
4863,24289,0,24289,3,24292,0
4864,24290,2,24292,3,24295,1
4865,24295,0,24295,3,24298,0
4866,24299,0,24299,3,24302,0
4867,24305,0,24305,3,24308,0
4868,24311,0,24311,3,24314,0
4869,24320,0,24320,3,24323,0
4870,24327,0,24327,3,24330,0
4871,24331,0,24331,3,24334,0
4871,24334,0,24334,3,24337,0
4872,24339,0,24339,3,24342,0
4872,24342,0,24342,3,24345,0
4873,24342,3,24345,3,24348,1
4874,24347,1,24348,3,24351,1
4874,24351,0,24351,3,24354,0
4875,24352,2,24354,3,24357,1
4874,24354,3,24357,3,24360,1
4875,24360,0,24360,3,24363,0
4876,24360,3,24363,3,24366,1
4877,24369,0,24369,3,24372,0
4878,24374,0,24374,3,24377,0
4879,24378,0,24378,3,24381,0
4879,24381,0,24381,3,24384,0
4880,24385,0,24385,3,24388,0
4881,24389,0,24389,3,24392,0
4882,24394,0,24394,3,24397,0
4883,24400,0,24400,3,24403,0
4884,24404,0,24404,3,24407,0
4885,24408,0,24408,3,24411,0
4885,24411,0,24411,3,24414,0
4886,24412,2,24414,3,24417,1
4887,24416,1,24417,3,24420,1
4888,24421,0,24421,3,24424,0
4889,24423,1,24424,3,24427,1
4890,24426,1,24427,3,24430,1
4889,24427,3,24430,3,24433,1
4891,24432,1,24433,3,24436,1
4891,24436,0,24436,3,24439,0
4892,24438,1,24439,3,24442,1
4891,24439,3,24442,3,24445,1
4893,24445,0,24445,3,24448,0
4893,24448,0,24448,3,24451,0
4894,24451,0,24451,3,24454,0
4895,24458,0,24458,3,24461,0
4896,24459,2,24461,3,24464,1
4897,24463,1,24464,3,24467,1
4898,24471,0,24471,3,24474,0
4899,24474,0,24474,3,24477,0
4900,24477,0,24477,3,24480,0
4901,24485,0,24485,3,24488,0
4901,24488,0,24488,3,24491,0
4902,24490,1,24491,3,24494,1
4902,24494,0,24494,3,24497,0
4903,24494,3,24497,3,24500,1
4904,24501,0,24501,3,24504,0
4905,24504,0,24504,3,24507,0
4906,24510,0,24510,3,24513,0
4907,24519,0,24519,3,24522,0
4908,24522,0,24522,3,24525,0
4909,24526,0,24526,3,24529,0
4909,24529,0,24529,3,24532,0
4910,24530,2,24532,3,24535,1
4911,24533,2,24535,3,24538,1
4912,24541,0,24541,3,24544,0
4913,24542,2,24544,3,24547,1
4912,24544,3,24547,3,24550,1
4914,24551,0,24551,3,24554,0
4914,24554,0,24554,3,24557,0
4915,24556,1,24557,3,24560,1
4916,24560,0,24560,3,24563,0
4917,24566,0,24566,3,24569,0
4918,24574,0,24574,3,24577,0
4919,24580,0,24580,3,24583,0
4920,24584,0,24584,3,24587,0
4921,24592,0,24592,3,24595,0
4922,24598,0,24598,3,24601,0
4923,24601,0,24601,3,24604,0
4924,24608,0,24608,3,24611,0
4925,24611,0,24611,3,24614,0
4926,24614,0,24614,3,24617,0
4926,24617,0,24617,3,24620,0
4927,24619,1,24620,3,24623,1
4928,24625,0,24625,3,24628,0
4928,24628,0,24628,3,24631,0
4929,24630,1,24631,3,24634,1
4929,24634,0,24634,3,24637,0
4930,24637,0,24637,3,24640,0
4931,24640,0,24640,3,24643,0
4931,24643,0,24643,3,24646,0
4932,24651,0,24651,3,24654,0
4933,24657,0,24657,3,24660,0
4934,24661,0,24661,3,24664,0
4935,24665,0,24665,3,24668,0
4935,24668,0,24668,3,24671,0
4936,24672,0,24672,3,24675,0
4936,24675,0,24675,3,24678,0
4937,24680,0,24680,3,24683,0
4937,24683,0,24683,3,24686,0
4938,24685,1,24686,3,24689,1
4939,24696,0,24696,3,24699,0
4940,24701,0,24701,3,24704,0
4941,24703,1,24704,3,24707,1
4941,24707,0,24707,3,24710,0
4942,24709,1,24710,3,24713,1
4943,24712,1,24713,3,24716,1
4944,24719,0,24719,3,24722,0
4944,24722,0,24722,3,24725,0
4945,24728,0,24728,3,24731,0
4946,24734,0,24734,3,24737,0
4946,24737,0,24737,3,24740,0
4947,24739,1,24740,3,24743,1
4948,24749,0,24749,3,24752,0
4949,24750,2,24752,3,24755,1
4950,24753,2,24755,3,24758,1
4951,24760,0,24760,3,24763,0
4952,24766,0,24766,3,24769,0
4953,24769,0,24769,3,24772,0
4954,24775,0,24775,3,24778,0
4955,24785,0,24785,3,24788,0
4955,24788,0,24788,3,24791,0
4956,24789,2,24791,3,24794,1
4955,24791,3,24794,3,24797,1
4957,24792,5,24797,3,24800,2
4955,24794,6,24800,3,24803,2
4958,24799,4,24803,3,24806,2
4957,24803,3,24806,3,24809,1
4957,24806,3,24809,3,24812,1
4959,24808,4,24812,3,24815,2
4957,24809,6,24815,3,24818,2
4957,24812,6,24818,3,24821,2
4960,24814,7,24821,3,24824,3
4961,24819,5,24824,3,24827,2
4962,24822,5,24827,3,24830,2
4963,24824,6,24830,3,24833,2
4964,24826,7,24833,3,24836,3
4965,24832,4,24836,3,24839,2
4966,24836,3,24839,3,24842,1
4965,24839,3,24842,3,24845,1
4967,24841,4,24845,3,24848,2
4968,24847,1,24848,3,24851,1
4969,24850,1,24851,3,24854,1
4970,24857,0,24857,3,24860,0
4971,24865,0,24865,3,24868,0
4972,24867,1,24868,3,24871,1
4973,24870,1,24871,3,24874,1
4973,24874,0,24874,3,24877,0
4974,24879,0,24879,3,24882,0
4975,24883,0,24883,3,24886,0
4976,24889,0,24889,3,24892,0
4977,24894,0,24894,3,24897,0
4977,24897,0,24897,3,24900,0
4978,24897,3,24900,3,24903,1
4979,24901,2,24903,3,24906,1
4980,24905,1,24906,3,24909,1
4981,24907,2,24909,3,24912,1
4980,24909,3,24912,3,24915,1
4980,24912,3,24915,3,24918,1
4982,24913,5,24918,3,24921,2
4983,24914,7,24921,3,24924,3
4984,24919,5,24924,3,24927,2
4982,24921,6,24927,3,24930,2
4985,24924,6,24930,3,24933,2
4986,24928,5,24933,3,24936,2
4987,24932,4,24936,3,24939,2
4988,24935,4,24939,3,24942,2
4989,24947,0,24947,3,24950,0
4990,24953,0,24953,3,24956,0
4990,24956,0,24956,3,24959,0
4991,24958,1,24959,3,24962,1
4992,24963,0,24963,3,24966,0
4992,24966,0,24966,3,24969,0
4993,24967,2,24969,3,24972,1
4994,24971,1,24972,3,24975,1
4993,24972,3,24975,3,24978,1
4995,24973,5,24978,3,24981,2
4996,24975,6,24981,3,24984,2
4997,24977,7,24984,3,24987,3
4998,24980,7,24987,3,24990,3
4999,24988,2,24990,3,24993,1
5000,24992,1,24993,3,24996,1
5001,24999,0,24999,3,25002,0
5002,25006,0,25006,3,25009,0
5002,25009,0,25009,3,25012,0
5003,25015,0,25015,3,25018,0
5004,25025,0,25025,3,25028,0
5004,25028,0,25028,3,25031,0
5005,25031,0,25031,3,25034,0
5006,25034,0,25034,3,25037,0
5007,25039,0,25039,3,25042,0
5008,25047,0,25047,3,25050,0
5008,25050,0,25050,3,25053,0
5008,25053,0,25053,3,25056,0
5009,25053,3,25056,3,25059,1
5008,25056,3,25059,3,25062,1
5010,25058,4,25062,3,25065,2
5009,25062,3,25065,3,25068,1
5011,25063,5,25068,3,25071,2
5012,25065,6,25071,3,25074,2
5013,25071,3,25074,3,25077,1
5014,25077,0,25077,3,25080,0
5014,25080,0,25080,3,25083,0
5015,25083,0,25083,3,25086,0
5016,25087,0,25087,3,25090,0
5017,25091,0,25091,3,25094,0
5017,25094,0,25094,3,25097,0
5018,25098,0,25098,3,25101,0
5019,25101,0,25101,3,25104,0
5020,25103,1,25104,3,25107,1
5019,25104,3,25107,3,25110,1
5021,25108,2,25110,3,25113,1
5021,25113,0,25113,3,25116,0
5021,25116,0,25116,3,25119,0
5022,25116,3,25119,3,25122,1
5023,25117,5,25122,3,25125,2
5024,25119,6,25125,3,25128,2
5025,25124,4,25128,3,25131,2
5024,25128,3,25131,3,25134,1
5026,25128,6,25134,3,25137,2
5027,25134,3,25137,3,25140,1
5028,25138,2,25140,3,25143,1
5029,25143,0,25143,3,25146,0
5029,25146,0,25146,3,25149,0
5030,25148,1,25149,3,25152,1
5031,25153,0,25153,3,25156,0
5032,25158,0,25158,3,25161,0
5033,25163,0,25163,3,25166,0
5034,25167,0,25167,3,25170,0
5034,25170,0,25170,3,25173,0
5035,25170,3,25173,3,25176,1
5036,25175,1,25176,3,25179,1
5037,25178,1,25179,3,25182,1
5038,25185,0,25185,3,25188,0
5038,25188,0,25188,3,25191,0
5039,25192,0,25192,3,25195,0
5040,25197,0,25197,3,25200,0
5041,25200,0,25200,3,25203,0
5042,25206,0,25206,3,25209,0
5042,25209,0,25209,3,25212,0
5043,25212,0,25212,3,25215,0
5044,25223,0,25223,3,25226,0
5045,25230,0,25230,3,25233,0
5046,25234,0,25234,3,25237,0
5046,25237,0,25237,3,25240,0
5047,25237,3,25240,3,25243,1
5047,25243,0,25243,3,25246,0
5048,25244,2,25246,3,25249,1
5047,25246,3,25249,3,25252,1
5049,25248,4,25252,3,25255,2
5050,25249,6,25255,3,25258,2
5048,25252,6,25258,3,25261,2
5051,25255,6,25261,3,25264,2
5052,25260,4,25264,3,25267,2
5053,25266,1,25267,3,25270,1
5054,25268,2,25270,3,25273,1
5053,25270,3,25273,3,25276,1
5055,25273,3,25276,3,25279,1
5056,25278,1,25279,3,25282,1
5055,25279,3,25282,3,25285,1
5057,25282,3,25285,3,25288,1
5058,25286,2,25288,3,25291,1
5059,25297,0,25297,3,25300,0
5060,25305,0,25305,3,25308,0
5060,25308,0,25308,3,25311,0
5061,25308,3,25311,3,25314,1
5062,25314,0,25314,3,25317,0
5063,25321,0,25321,3,25324,0
5063,25324,0,25324,3,25327,0
5064,25324,3,25327,3,25330,1
5065,25331,0,25331,3,25334,0
5066,25337,0,25337,3,25340,0
5067,25344,0,25344,3,25347,0
5068,25347,0,25347,3,25350,0
5068,25350,0,25350,3,25353,0
5069,25351,2,25353,3,25356,1
5068,25353,3,25356,3,25359,1
5070,25356,3,25359,3,25362,1
5071,25362,0,25362,3,25365,0
5071,25365,0,25365,3,25368,0
5072,25368,0,25368,3,25371,0
5072,25371,0,25371,3,25374,0
5073,25372,2,25374,3,25377,1
5074,25374,3,25377,3,25380,1
5074,25380,0,25380,3,25383,0
5075,25380,3,25383,3,25386,1
5076,25383,3,25386,3,25389,1
5077,25384,5,25389,3,25392,2
5078,25388,4,25392,3,25395,2
5079,25394,1,25395,3,25398,1
5078,25395,3,25398,3,25401,1
5080,25399,2,25401,3,25404,1
5081,25406,0,25406,3,25409,0
5081,25409,0,25409,3,25412,0
5082,25409,3,25412,3,25415,1
5081,25412,3,25415,3,25418,1
5083,25414,4,25418,3,25421,2
5084,25419,2,25421,3,25424,1
5085,25422,2,25424,3,25427,1
5084,25424,3,25427,3,25430,1
5086,25424,6,25430,3,25433,2
5087,25427,6,25433,3,25436,2
5088,25431,5,25436,3,25439,2
5089,25438,1,25439,3,25442,1
5088,25439,3,25442,3,25445,1
5088,25442,3,25445,3,25448,1
5090,25444,4,25448,3,25451,2
5091,25448,3,25451,3,25454,1
5092,25451,3,25454,3,25457,1
5093,25457,0,25457,3,25460,0
5094,25458,2,25460,3,25463,1
5095,25463,0,25463,3,25466,0
5096,25467,0,25467,3,25470,0
5097,25471,0,25471,3,25474,0
5098,25472,2,25474,3,25477,1
5099,25474,3,25477,3,25480,1
5100,25482,0,25482,3,25485,0
5101,25486,0,25486,3,25489,0
5102,25492,0,25492,3,25495,0
5103,25494,1,25495,3,25498,1
5104,25500,0,25500,3,25503,0
5105,25501,2,25503,3,25506,1
5104,25503,3,25506,3,25509,1
5106,25503,6,25509,3,25512,2
5107,25509,3,25512,3,25515,1
5108,25515,0,25515,3,25518,0
5109,25518,0,25518,3,25521,0
5110,25525,0,25525,3,25528,0
5111,25528,0,25528,3,25531,0
5112,25534,0,25534,3,25537,0
5112,25537,0,25537,3,25540,0
5113,25540,0,25540,3,25543,0
5114,25544,0,25544,3,25547,0
5115,25549,0,25549,3,25552,0
5116,25557,0,25557,3,25560,0
5117,25562,0,25562,3,25565,0
5118,25566,0,25566,3,25569,0
5119,25569,0,25569,3,25572,0
5120,25569,3,25572,3,25575,1
5121,25577,0,25577,3,25580,0
5121,25580,0,25580,3,25583,0
5121,25583,0,25583,3,25586,0
5122,25583,3,25586,3,25589,1
5123,25584,5,25589,3,25592,2
5124,25588,4,25592,3,25595,2
5125,25592,3,25595,3,25598,1
5126,25596,2,25598,3,25601,1
5125,25598,3,25601,3,25604,1
5125,25601,3,25604,3,25607,1
5127,25601,6,25607,3,25610,2
5125,25604,6,25610,3,25613,2
5125,25607,6,25613,3,25616,2
5128,25607,9,25616,3,25619,3
5125,25610,9,25619,3,25622,3
5129,25610,12,25622,3,25625,4
5125,25613,12,25625,3,25628,4
5130,25618,10,25628,3,25631,4
5126,25619,12,25631,3,25634,4
5131,25624,10,25634,3,25637,4
5132,25629,8,25637,3,25640,3
5129,25631,9,25640,3,25643,3
5133,25632,11,25643,3,25646,4
5134,25637,9,25646,3,25649,3
5131,25640,9,25649,3,25652,3
5135,25641,11,25652,3,25655,4
5136,25642,13,25655,3,25658,5
5137,25646,12,25658,3,25661,4
5133,25649,12,25661,3,25664,4
5138,25652,12,25664,3,25667,4
5139,25657,10,25667,3,25670,4
5140,25662,8,25670,3,25673,3
5141,25668,5,25673,3,25676,2
5140,25673,3,25676,3,25679,1
5142,25675,4,25679,3,25682,2
5143,25679,3,25682,3,25685,1
5142,25682,3,25685,3,25688,1
5144,25685,3,25688,3,25691,1
5145,25691,0,25691,3,25694,0
5146,25697,0,25697,3,25700,0
5147,25703,0,25703,3,25706,0
5147,25706,0,25706,3,25709,0
5148,25712,0,25712,3,25715,0
5148,25715,0,25715,3,25718,0
5149,25716,2,25718,3,25721,1
5150,25719,2,25721,3,25724,1
5151,25724,0,25724,3,25727,0
5152,25727,0,25727,3,25730,0
5152,25730,0,25730,3,25733,0
5153,25735,0,25735,3,25738,0
5153,25738,0,25738,3,25741,0
5154,25742,0,25742,3,25745,0
5154,25745,0,25745,3,25748,0
5155,25748,0,25748,3,25751,0
5156,25753,0,25753,3,25756,0
5157,25755,1,25756,3,25759,1
5157,25759,0,25759,3,25762,0
5158,25761,1,25762,3,25765,1
5159,25763,2,25765,3,25768,1
5158,25765,3,25768,3,25771,1
5158,25768,3,25771,3,25774,1
5160,25768,6,25774,3,25777,2
5161,25773,4,25777,3,25780,2
5162,25780,0,25780,3,25783,0
5163,25780,3,25783,3,25786,1
5164,25785,1,25786,3,25789,1
5163,25786,3,25789,3,25792,1
5165,25788,4,25792,3,25795,2
5166,25791,4,25795,3,25798,2
5165,25795,3,25798,3,25801,1
5167,25797,4,25801,3,25804,2
5168,25807,0,25807,3,25810,0
5169,25815,0,25815,3,25818,0
5170,25817,1,25818,3,25821,1
5171,25819,2,25821,3,25824,1
5172,25822,2,25824,3,25827,1
5173,25834,0,25834,3,25837,0
5174,25838,0,25838,3,25841,0
5175,25846,0,25846,3,25849,0
5176,25849,0,25849,3,25852,0
5177,25850,2,25852,3,25855,1
5176,25852,3,25855,3,25858,1
5178,25856,2,25858,3,25861,1
5179,25859,2,25861,3,25864,1
5178,25861,3,25864,3,25867,1
5180,25870,0,25870,3,25873,0
5180,25873,0,25873,3,25876,0
5181,25873,3,25876,3,25879,1
5181,25879,0,25879,3,25882,0
5182,25880,2,25882,3,25885,1
5183,25884,1,25885,3,25888,1
5184,25888,0,25888,3,25891,0
5185,25890,1,25891,3,25894,1
5186,25899,0,25899,3,25902,0
5187,25906,0,25906,3,25909,0
5188,25909,0,25909,3,25912,0
5189,25910,2,25912,3,25915,1
5188,25912,3,25915,3,25918,1
5190,25917,1,25918,3,25921,1
5191,25920,1,25921,3,25924,1
5192,25923,1,25924,3,25927,1
5191,25924,3,25927,3,25930,1
5193,25926,4,25930,3,25933,2
5194,25929,4,25933,3,25936,2
5192,25930,6,25936,3,25939,2
5192,25933,6,25939,3,25942,2
5195,25934,8,25942,3,25945,3
5196,25940,5,25945,3,25948,2
5197,25945,3,25948,3,25951,1
5198,25953,0,25953,3,25956,0
5199,25959,0,25959,3,25962,0
5200,25964,0,25964,3,25967,0
5201,25971,0,25971,3,25974,0
5202,25982,0,25982,3,25985,0
5203,25986,0,25986,3,25989,0
5204,25988,1,25989,3,25992,1
5205,25989,3,25992,3,25995,1
5204,25992,3,25995,3,25998,1
5206,25995,3,25998,3,26001,1
5207,25999,2,26001,3,26004,1
5207,26004,0,26004,3,26007,0
5208,26006,1,26007,3,26010,1
5209,26011,0,26011,3,26014,0
5210,26012,2,26014,3,26017,1
5210,26017,0,26017,3,26020,0
5211,26017,3,26020,3,26023,1
5212,26020,3,26023,3,26026,1
5213,26027,0,26027,3,26030,0
5214,26030,0,26030,3,26033,0
5214,26033,0,26033,3,26036,0
5215,26037,0,26037,3,26040,0
5216,26043,0,26043,3,26046,0
5217,26051,0,26051,3,26054,0
5217,26054,0,26054,3,26057,0
5218,26056,1,26057,3,26060,1
5219,26060,0,26060,3,26063,0
5220,26064,0,26064,3,26067,0
5221,26067,0,26067,3,26070,0
5222,26070,0,26070,3,26073,0
5223,26075,0,26075,3,26078,0
5224,26081,0,26081,3,26084,0
5225,26086,0,26086,3,26089,0
5225,26089,0,26089,3,26092,0
5226,26095,0,26095,3,26098,0
5227,26098,0,26098,3,26101,0
5228,26105,0,26105,3,26108,0
5229,26110,0,26110,3,26113,0
5229,26113,0,26113,3,26116,0
5230,26113,3,26116,3,26119,1
5231,26118,1,26119,3,26122,1
5231,26122,0,26122,3,26125,0
5232,26123,2,26125,3,26128,1
5231,26125,3,26128,3,26131,1
5233,26127,4,26131,3,26134,2
5231,26128,6,26134,3,26137,2
5234,26131,6,26137,3,26140,2
5235,26134,6,26140,3,26143,2
5235,26143,0,26143,3,26146,0
5236,26144,2,26146,3,26149,1
5236,26149,0,26149,3,26152,0
5237,26149,3,26152,3,26155,1
5238,26152,3,26155,3,26158,1
5237,26155,3,26158,3,26161,1
5239,26158,3,26161,3,26164,1
5240,26161,3,26164,3,26167,1
5239,26164,3,26167,3,26170,1
5241,26164,6,26170,3,26173,2
5242,26166,7,26173,3,26176,3
5239,26167,9,26176,3,26179,3
5239,26170,9,26179,3,26182,3
5243,26172,10,26182,3,26185,4
5244,26177,8,26185,3,26188,3
5245,26179,9,26188,3,26191,3
5242,26182,9,26191,3,26194,3
5246,26187,7,26194,3,26197,3
5243,26188,9,26197,3,26200,3
5243,26191,9,26200,3,26203,3
5247,26193,10,26203,3,26206,4
5248,26198,8,26206,3,26209,3
5249,26201,8,26209,3,26212,3
5250,26204,8,26212,3,26215,3
5251,26207,8,26215,3,26218,3
5252,26211,7,26218,3,26221,3
5253,26218,3,26221,3,26224,1
5254,26223,1,26224,3,26227,1
5253,26224,3,26227,3,26230,1
5255,26228,2,26230,3,26233,1
5254,26230,3,26233,3,26236,1
5256,26234,2,26236,3,26239,1
5256,26239,0,26239,3,26242,0
5257,26239,3,26242,3,26245,1
5257,26245,0,26245,3,26248,0
5258,26245,3,26248,3,26251,1
5259,26249,2,26251,3,26254,1
5260,26256,0,26256,3,26259,0
5260,26259,0,26259,3,26262,0
5261,26260,2,26262,3,26265,1
5262,26264,1,26265,3,26268,1
5261,26265,3,26268,3,26271,1
5263,26272,0,26272,3,26275,0
5264,26276,0,26276,3,26279,0
5264,26279,0,26279,3,26282,0
5265,26281,1,26282,3,26285,1
5266,26285,0,26285,3,26288,0
5267,26290,0,26290,3,26293,0
5268,26297,0,26297,3,26300,0
5269,26303,0,26303,3,26306,0
5270,26307,0,26307,3,26310,0
5271,26309,1,26310,3,26313,1
5272,26311,2,26313,3,26316,1
5272,26316,0,26316,3,26319,0
5273,26317,2,26319,3,26322,1
5272,26319,3,26322,3,26325,1
5272,26322,3,26325,3,26328,1
5272,26325,3,26328,3,26331,1
5274,26325,6,26331,3,26334,2
5275,26330,4,26334,3,26337,2
5273,26331,6,26337,3,26340,2
5276,26338,2,26340,3,26343,1
5277,26342,1,26343,3,26346,1
5278,26349,0,26349,3,26352,0
5278,26352,0,26352,3,26355,0
5278,26355,0,26355,3,26358,0
5279,26355,3,26358,3,26361,1
5280,26359,2,26361,3,26364,1
5279,26361,3,26364,3,26367,1
5281,26363,4,26367,3,26370,2
5280,26367,3,26370,3,26373,1
5282,26367,6,26373,3,26376,2
5280,26370,6,26376,3,26379,2
5280,26373,6,26379,3,26382,2
5283,26373,9,26382,3,26385,3
5280,26376,9,26385,3,26388,3
5284,26377,11,26388,3,26391,4
5280,26379,12,26391,3,26394,4
5285,26383,11,26394,3,26397,4
5286,26385,12,26397,3,26400,4
5282,26388,12,26400,3,26403,4
5282,26391,12,26403,3,26406,4
5287,26391,15,26406,3,26409,5
5288,26395,14,26409,3,26412,5
5289,26396,16,26412,3,26415,6
5283,26397,18,26415,3,26418,6
5290,26401,17,26418,3,26421,6
5284,26403,18,26421,3,26424,6
5291,26408,16,26424,3,26427,6
5285,26409,18,26427,3,26430,6
5292,26412,18,26430,3,26433,6
5293,26417,16,26433,3,26436,6
5287,26418,18,26436,3,26439,6
5287,26421,18,26439,3,26442,6
5294,26422,20,26442,3,26445,7
5295,26428,17,26445,3,26448,6
5296,26433,15,26448,3,26451,5
5291,26436,15,26451,3,26454,5
5297,26439,15,26454,3,26457,5
5298,26439,18,26457,3,26460,6
5299,26442,18,26460,3,26463,6
5300,26444,19,26463,3,26466,7
5301,26450,16,26466,3,26469,6
5296,26454,15,26469,3,26472,5
5302,26455,17,26472,3,26475,6
5303,26461,14,26475,3,26478,5
5304,26466,12,26478,3,26481,4
5305,26469,12,26481,3,26484,4
5306,26473,11,26484,3,26487,4
5307,26477,10,26487,3,26490,4
5303,26478,12,26490,3,26493,4
5308,26485,8,26493,3,26496,3
5306,26490,6,26496,3,26499,2
5309,26494,5,26499,3,26502,2
5310,26499,3,26502,3,26505,1
5310,26505,0,26505,3,26508,0
5311,26505,3,26508,3,26511,1
5310,26508,3,26511,3,26514,1
5312,26510,4,26514,3,26517,2
5313,26517,0,26517,3,26520,0
5314,26525,0,26525,3,26528,0
5314,26528,0,26528,3,26531,0
5315,26529,2,26531,3,26534,1
5314,26531,3,26534,3,26537,1
5316,26533,4,26537,3,26540,2
5317,26537,3,26540,3,26543,1
5318,26540,3,26543,3,26546,1
5319,26543,3,26546,3,26549,1
5319,26549,0,26549,3,26552,0
5320,26549,3,26552,3,26555,1
5321,26551,4,26555,3,26558,2
5319,26552,6,26558,3,26561,2
5319,26555,6,26561,3,26564,2
5319,26558,6,26564,3,26567,2
5322,26558,9,26567,3,26570,3
5323,26560,10,26570,3,26573,4
5319,26561,12,26573,3,26576,4
5324,26566,10,26576,3,26579,4
5325,26570,9,26579,3,26582,3
5322,26573,9,26582,3,26585,3
5326,26574,11,26585,3,26588,4
5327,26581,7,26588,3,26591,3
5325,26585,6,26591,3,26594,2
5328,26587,7,26594,3,26597,3
5325,26588,9,26597,3,26600,3
5325,26591,9,26600,3,26603,3
5329,26593,10,26603,3,26606,4
5330,26600,6,26606,3,26609,2
5328,26603,6,26609,3,26612,2
5331,26605,7,26612,3,26615,3
5328,26606,9,26615,3,26618,3
5332,26609,9,26618,3,26621,3
5330,26615,6,26621,3,26624,2
5333,26617,7,26624,3,26627,3
5330,26618,9,26627,3,26630,3
5334,26620,10,26630,3,26633,4
5335,26624,9,26633,3,26636,3
5336,26624,12,26636,3,26639,4
5337,26634,5,26639,3,26642,2
5338,26640,2,26642,3,26645,1
5339,26646,0,26646,3,26649,0
5340,26649,0,26649,3,26652,0
5341,26655,0,26655,3,26658,0
5342,26661,0,26661,3,26664,0
5343,26662,2,26664,3,26667,1
5344,26669,0,26669,3,26672,0
5344,26672,0,26672,3,26675,0
5344,26675,0,26675,3,26678,0
5345,26678,0,26678,3,26681,0
5346,26681,0,26681,3,26684,0
5347,26689,0,26689,3,26692,0
5348,26695,0,26695,3,26698,0
5348,26698,0,26698,3,26701,0
5348,26701,0,26701,3,26704,0
5349,26701,3,26704,3,26707,1
5350,26702,5,26707,3,26710,2
5351,26706,4,26710,3,26713,2
5352,26709,4,26713,3,26716,2
5350,26710,6,26716,3,26719,2
5353,26715,4,26719,3,26722,2
5352,26719,3,26722,3,26725,1
5354,26721,4,26725,3,26728,2
5352,26722,6,26728,3,26731,2
5355,26726,5,26731,3,26734,2
5356,26730,4,26734,3,26737,2
5357,26734,3,26737,3,26740,1
5358,26740,0,26740,3,26743,0
5359,26744,0,26744,3,26747,0
5359,26747,0,26747,3,26750,0
5360,26749,1,26750,3,26753,1
5359,26750,3,26753,3,26756,1
5361,26757,0,26757,3,26760,0
5362,26762,0,26762,3,26765,0
5363,26766,0,26766,3,26769,0
5364,26772,0,26772,3,26775,0
5365,26778,0,26778,3,26781,0
5366,26780,1,26781,3,26784,1
5367,26785,0,26785,3,26788,0
5368,26790,0,26790,3,26793,0
5368,26793,0,26793,3,26796,0
5369,26795,1,26796,3,26799,1
5369,26799,0,26799,3,26802,0
5370,26800,2,26802,3,26805,1
5371,26808,0,26808,3,26811,0
5372,26814,0,26814,3,26817,0
5373,26826,0,26826,3,26829,0
5374,26829,0,26829,3,26832,0
5375,26831,1,26832,3,26835,1
5376,26833,2,26835,3,26838,1
5377,26837,1,26838,3,26841,1
5378,26841,0,26841,3,26844,0
5379,26844,0,26844,3,26847,0
5379,26847,0,26847,3,26850,0
5380,26849,1,26850,3,26853,1
5380,26853,0,26853,3,26856,0
5381,26857,0,26857,3,26860,0
5382,26858,2,26860,3,26863,1
5382,26863,0,26863,3,26866,0
5383,26867,0,26867,3,26870,0
5383,26870,0,26870,3,26873,0
5384,26870,3,26873,3,26876,1
5385,26873,3,26876,3,26879,1
5386,26880,0,26880,3,26883,0
5387,26886,0,26886,3,26889,0
5388,26893,0,26893,3,26896,0
5389,26900,0,26900,3,26903,0
5390,26904,0,26904,3,26907,0
5391,26911,0,26911,3,26914,0
5391,26914,0,26914,3,26917,0
5392,26915,2,26917,3,26920,1
5393,26917,3,26920,3,26923,1
5394,26919,4,26923,3,26926,2
5392,26920,6,26926,3,26929,2
5395,26924,5,26929,3,26932,2
5396,26929,3,26932,3,26935,1
5397,26936,0,26936,3,26939,0
5398,26942,0,26942,3,26945,0
5399,26947,0,26947,3,26950,0
5400,26950,0,26950,3,26953,0
5401,26955,0,26955,3,26958,0
5402,26960,0,26960,3,26963,0
5402,26963,0,26963,3,26966,0
5402,26966,0,26966,3,26969,0
5402,26969,0,26969,3,26972,0
5403,26969,3,26972,3,26975,1
5404,26975,0,26975,3,26978,0
5405,26978,0,26978,3,26981,0
5406,26982,0,26982,3,26985,0
5406,26985,0,26985,3,26988,0
5407,26990,0,26990,3,26993,0
5408,26997,0,26997,3,27000,0
5409,27001,0,27001,3,27004,0
5410,27007,0,27007,3,27010,0
5411,27015,0,27015,3,27018,0
5412,27024,0,27024,3,27027,0
5413,27030,0,27030,3,27033,0
5414,27036,0,27036,3,27039,0
5414,27039,0,27039,3,27042,0
5414,27042,0,27042,3,27045,0
5415,27043,2,27045,3,27048,1
5416,27049,0,27049,3,27052,0
5417,27056,0,27056,3,27059,0
5418,27059,0,27059,3,27062,0
5419,27068,0,27068,3,27071,0
5420,27074,0,27074,3,27077,0
5421,27078,0,27078,3,27081,0
5422,27085,0,27085,3,27088,0
5423,27091,0,27091,3,27094,0
5424,27098,0,27098,3,27101,0
5425,27100,1,27101,3,27104,1
5426,27106,0,27106,3,27109,0
5427,27109,0,27109,3,27112,0
5427,27112,0,27112,3,27115,0
5428,27113,2,27115,3,27118,1
5429,27120,0,27120,3,27123,0
5430,27126,0,27126,3,27129,0
5431,27127,2,27129,3,27132,1
5432,27130,2,27132,3,27135,1
5433,27132,3,27135,3,27138,1
5433,27138,0,27138,3,27141,0
5434,27138,3,27141,3,27144,1
5435,27143,1,27144,3,27147,1
5436,27147,0,27147,3,27150,0
5437,27152,0,27152,3,27155,0
5438,27161,0,27161,3,27164,0
5439,27165,0,27165,3,27168,0
5439,27168,0,27168,3,27171,0
5440,27169,2,27171,3,27174,1
5439,27171,3,27174,3,27177,1
5441,27171,6,27177,3,27180,2
5440,27177,3,27180,3,27183,1
5440,27180,3,27183,3,27186,1
5442,27181,5,27186,3,27189,2
5440,27183,6,27189,3,27192,2
5440,27186,6,27192,3,27195,2
5440,27189,6,27195,3,27198,2
5443,27189,9,27198,3,27201,3
5444,27190,11,27201,3,27204,4
5440,27192,12,27204,3,27207,4
5445,27194,13,27207,3,27210,5
5440,27195,15,27210,3,27213,5
5446,27197,16,27213,3,27216,6
5447,27201,15,27216,3,27219,5
5442,27204,15,27219,3,27222,5
5448,27204,18,27222,3,27225,6
5449,27210,15,27225,3,27228,5
5444,27213,15,27228,3,27231,5
5450,27213,18,27231,3,27234,6
5445,27219,15,27234,3,27237,5
5451,27220,17,27237,3,27240,6
5446,27225,15,27240,3,27243,5
5452,27227,16,27243,3,27246,6
5447,27231,15,27246,3,27249,5
5453,27231,18,27249,3,27252,6
5454,27234,18,27252,3,27255,6
5455,27242,13,27255,3,27258,5
5450,27243,15,27258,3,27261,5
5456,27250,11,27261,3,27264,4
5452,27252,12,27264,3,27267,4
5457,27255,12,27267,3,27270,4
5458,27262,8,27270,3,27273,3
5459,27265,8,27273,3,27276,3
5460,27267,9,27276,3,27279,3
5457,27270,9,27279,3,27282,3
5461,27270,12,27282,3,27285,4
5462,27275,10,27285,3,27288,4
5458,27276,12,27288,3,27291,4
5459,27282,9,27291,3,27294,3
5463,27282,12,27294,3,27297,4
5464,27285,12,27297,3,27300,4
5460,27288,12,27300,3,27303,4
5465,27289,14,27303,3,27306,5
5466,27296,10,27306,3,27309,4
5467,27300,9,27309,3,27312,3
5468,27305,7,27312,3,27315,3
5465,27306,9,27315,3,27318,3
5465,27309,9,27318,3,27321,3
5469,27312,9,27321,3,27324,3
5470,27313,11,27324,3,27327,4
5471,27319,8,27327,3,27330,3
5469,27324,6,27330,3,27333,2
5469,27327,6,27333,3,27336,2
5472,27328,8,27336,3,27339,3
5470,27333,6,27339,3,27342,2
5473,27333,9,27342,3,27345,3
5474,27334,11,27345,3,27348,4
5475,27337,11,27348,3,27351,4
5476,27343,8,27351,3,27354,3
5473,27345,9,27354,3,27357,3
5477,27346,11,27357,3,27360,4
5478,27352,8,27360,3,27363,3
5476,27357,6,27363,3,27366,2
5479,27361,5,27366,3,27369,2
5480,27366,3,27369,3,27372,1
5479,27369,3,27372,3,27375,1
5481,27375,0,27375,3,27378,0
5482,27380,0,27380,3,27383,0
5483,27384,0,27384,3,27387,0
5483,27387,0,27387,3,27390,0
5484,27387,3,27390,3,27393,1
5484,27393,0,27393,3,27396,0
5485,27393,3,27396,3,27399,1
5486,27401,0,27401,3,27404,0
5487,27405,0,27405,3,27408,0
5488,27408,0,27408,3,27411,0
5489,27414,0,27414,3,27417,0
5489,27417,0,27417,3,27420,0
5490,27419,1,27420,3,27423,1
5490,27423,0,27423,3,27426,0
5491,27423,3,27426,3,27429,1
5492,27428,1,27429,3,27432,1
5491,27429,3,27432,3,27435,1
5493,27432,3,27435,3,27438,1
5494,27438,0,27438,3,27441,0
5494,27441,0,27441,3,27444,0
5495,27441,3,27444,3,27447,1
5494,27444,3,27447,3,27450,1
5496,27445,5,27450,3,27453,2
5497,27451,2,27453,3,27456,1
5496,27453,3,27456,3,27459,1
5498,27454,5,27459,3,27462,2
5496,27456,6,27462,3,27465,2
5499,27461,4,27465,3,27468,2
5500,27465,3,27468,3,27471,1
5500,27471,0,27471,3,27474,0
5501,27471,3,27474,3,27477,1
5500,27474,3,27477,3,27480,1
5502,27478,2,27480,3,27483,1
5503,27482,1,27483,3,27486,1
5502,27483,3,27486,3,27489,1
5504,27490,0,27490,3,27493,0
5505,27497,0,27497,3,27500,0
5505,27500,0,27500,3,27503,0
5506,27505,0,27505,3,27508,0
5507,27508,0,27508,3,27511,0
5508,27517,0,27517,3,27520,0
5509,27524,0,27524,3,27527,0
5510,27532,0,27532,3,27535,0
5511,27536,0,27536,3,27539,0
5512,27540,0,27540,3,27543,0
5512,27543,0,27543,3,27546,0
5513,27545,1,27546,3,27549,1
5512,27546,3,27549,3,27552,1
5512,27549,3,27552,3,27555,1
5514,27549,6,27555,3,27558,2
5515,27551,7,27558,3,27561,3
5512,27552,9,27561,3,27564,3
5516,27555,9,27564,3,27567,3
5517,27561,6,27567,3,27570,2
5518,27562,8,27570,3,27573,3
5515,27564,9,27573,3,27576,3
5519,27566,10,27576,3,27579,4
5515,27567,12,27579,3,27582,4
5520,27569,13,27582,3,27585,5
5515,27570,15,27585,3,27588,5
5521,27577,11,27588,3,27591,4
5518,27582,9,27591,3,27594,3
5522,27584,10,27594,3,27597,4
5523,27589,8,27597,3,27600,3
5520,27591,9,27600,3,27603,3
5524,27593,10,27603,3,27606,4
5525,27599,7,27606,3,27609,3
5526,27605,4,27609,3,27612,2
5524,27606,6,27612,3,27615,2
5527,27611,4,27615,3,27618,2
5525,27612,6,27618,3,27621,2
5528,27616,5,27621,3,27624,2
5527,27621,3,27624,3,27627,1
5529,27621,6,27627,3,27630,2
5527,27624,6,27630,3,27633,2
5530,27624,9,27633,3,27636,3
5527,27627,9,27636,3,27639,3
5531,27630,9,27639,3,27642,3
5528,27633,9,27642,3,27645,3
5532,27633,12,27645,3,27648,4
5533,27640,8,27648,3,27651,3
5534,27641,10,27651,3,27654,4
5531,27645,9,27654,3,27657,3
5531,27648,9,27657,3,27660,3
5535,27649,11,27660,3,27663,4
5536,27655,8,27663,3,27666,3
5537,27660,6,27666,3,27669,2
5538,27667,2,27669,3,27672,1
5537,27669,3,27672,3,27675,1
5539,27671,4,27675,3,27678,2
5538,27675,3,27678,3,27681,1
5540,27675,6,27681,3,27684,2
5541,27679,5,27684,3,27687,2
5542,27683,4,27687,3,27690,2
5541,27687,3,27690,3,27693,1
5543,27689,4,27693,3,27696,2
5544,27691,5,27696,3,27699,2
5545,27700,0,27700,3,27703,0
5546,27701,2,27703,3,27706,1
5545,27703,3,27706,3,27709,1
5545,27706,3,27709,3,27712,1
5547,27707,5,27712,3,27715,2
5546,27712,3,27715,3,27718,1
5548,27712,6,27718,3,27721,2
5549,27715,6,27721,3,27724,2
5550,27726,0,27726,3,27729,0
5551,27731,0,27731,3,27734,0
5552,27741,0,27741,3,27744,0
5553,27742,2,27744,3,27747,1
5552,27744,3,27747,3,27750,1
5554,27749,1,27750,3,27753,1
5553,27750,3,27753,3,27756,1
5555,27753,3,27756,3,27759,1
5556,27759,0,27759,3,27762,0
5557,27762,0,27762,3,27765,0
5558,27770,0,27770,3,27773,0
5559,27777,0,27777,3,27780,0
5560,27782,0,27782,3,27785,0
5561,27790,0,27790,3,27793,0
5562,27793,0,27793,3,27796,0
5563,27797,0,27797,3,27800,0
5564,27802,0,27802,3,27805,0
5564,27805,0,27805,3,27808,0
5565,27805,3,27808,3,27811,1
5566,27809,2,27811,3,27814,1
5567,27815,0,27815,3,27818,0
5567,27818,0,27818,3,27821,0
5568,27819,2,27821,3,27824,1
5567,27821,3,27824,3,27827,1
5569,27827,0,27827,3,27830,0
5570,27831,0,27831,3,27834,0
5571,27835,0,27835,3,27838,0
5572,27838,0,27838,3,27841,0
5573,27843,0,27843,3,27846,0
5574,27847,0,27847,3,27850,0
5575,27854,0,27854,3,27857,0
5576,27858,0,27858,3,27861,0
5576,27861,0,27861,3,27864,0
5577,27864,0,27864,3,27867,0
5578,27873,0,27873,3,27876,0
5579,27881,0,27881,3,27884,0
5580,27884,0,27884,3,27887,0
5581,27885,2,27887,3,27890,1
5582,27887,3,27890,3,27893,1
5583,27893,0,27893,3,27896,0
5584,27896,0,27896,3,27899,0
5584,27899,0,27899,3,27902,0
5585,27903,0,27903,3,27906,0
5586,27908,0,27908,3,27911,0
5587,27910,1,27911,3,27914,1
5588,27914,0,27914,3,27917,0
5589,27922,0,27922,3,27925,0
5590,27925,0,27925,3,27928,0
5591,27930,0,27930,3,27933,0
5591,27933,0,27933,3,27936,0
5592,27936,0,27936,3,27939,0
5593,27940,0,27940,3,27943,0
5594,27944,0,27944,3,27947,0
5594,27947,0,27947,3,27950,0
5595,27949,1,27950,3,27953,1
5596,27957,0,27957,3,27960,0
5596,27960,0,27960,3,27963,0
5597,27961,2,27963,3,27966,1
5596,27963,3,27966,3,27969,1
5598,27965,4,27969,3,27972,2
5599,27970,2,27972,3,27975,1
5600,27975,0,27975,3,27978,0
5600,27978,0,27978,3,27981,0
5601,27979,2,27981,3,27984,1
5602,27986,0,27986,3,27989,0
5603,27992,0,27992,3,27995,0
5604,27997,0,27997,3,28000,0
5605,28002,0,28002,3,28005,0
5606,28008,0,28008,3,28011,0
5606,28011,0,28011,3,28014,0
5607,28012,2,28014,3,28017,1
5608,28015,2,28017,3,28020,1
5607,28017,3,28020,3,28023,1
5609,28022,1,28023,3,28026,1
5610,28023,3,28026,3,28029,1
5611,28024,5,28029,3,28032,2
5612,28032,0,28032,3,28035,0
5613,28035,0,28035,3,28038,0
5614,28039,0,28039,3,28042,0
5615,28042,0,28042,3,28045,0
5616,28043,2,28045,3,28048,1
5617,28047,1,28048,3,28051,1
5618,28052,0,28052,3,28055,0
5618,28055,0,28055,3,28058,0
5619,28055,3,28058,3,28061,1
5620,28062,0,28062,3,28065,0
5621,28068,0,28068,3,28071,0
5622,28079,0,28079,3,28082,0
5623,28082,0,28082,3,28085,0
5623,28085,0,28085,3,28088,0
5624,28087,1,28088,3,28091,1
5625,28093,0,28093,3,28096,0
5626,28097,0,28097,3,28100,0
5627,28101,0,28101,3,28104,0
5628,28103,1,28104,3,28107,1
5629,28106,1,28107,3,28110,1
5629,28110,0,28110,3,28113,0
5630,28111,2,28113,3,28116,1
5631,28116,0,28116,3,28119,0
5632,28117,2,28119,3,28122,1
5632,28122,0,28122,3,28125,0
5633,28123,2,28125,3,28128,1
5634,28126,2,28128,3,28131,1
5633,28128,3,28131,3,28134,1
5635,28131,3,28134,3,28137,1
5636,28138,0,28138,3,28141,0
5637,28144,0,28144,3,28147,0
5638,28148,0,28148,3,28151,0
5639,28150,1,28151,3,28154,1
5640,28159,0,28159,3,28162,0
5640,28162,0,28162,3,28165,0
5641,28164,1,28165,3,28168,1
5642,28171,0,28171,3,28174,0
5643,28174,0,28174,3,28177,0
5644,28178,0,28178,3,28181,0
5645,28182,0,28182,3,28185,0
5646,28186,0,28186,3,28189,0
5647,28189,0,28189,3,28192,0
5648,28193,0,28193,3,28196,0
5649,28196,0,28196,3,28199,0
5649,28199,0,28199,3,28202,0
5650,28200,2,28202,3,28205,1
5651,28206,0,28206,3,28209,0
5652,28206,3,28209,3,28212,1
5653,28211,1,28212,3,28215,1
5653,28215,0,28215,3,28218,0
5654,28215,3,28218,3,28221,1
5655,28218,3,28221,3,28224,1
5656,28220,4,28224,3,28227,2
5654,28221,6,28227,3,28230,2
5657,28222,8,28230,3,28233,3
5654,28224,9,28233,3,28236,3
5658,28230,6,28236,3,28239,2
5657,28236,3,28239,3,28242,1
5659,28237,5,28242,3,28245,2
5660,28239,6,28245,3,28248,2
5661,28243,5,28248,3,28251,2
5662,28252,0,28252,3,28255,0
5663,28257,0,28257,3,28260,0
5664,28261,0,28261,3,28264,0
5664,28264,0,28264,3,28267,0
5665,28265,2,28267,3,28270,1
5664,28267,3,28270,3,28273,1
5666,28270,3,28273,3,28276,1
5667,28271,5,28276,3,28279,2
5668,28277,2,28279,3,28282,1
5668,28282,0,28282,3,28285,0
5669,28283,2,28285,3,28288,1
5669,28288,0,28288,3,28291,0
5670,28288,3,28291,3,28294,1
5671,28291,3,28294,3,28297,1
5672,28294,3,28297,3,28300,1
5673,28301,0,28301,3,28304,0
5674,28303,1,28304,3,28307,1
5675,28305,2,28307,3,28310,1
5675,28310,0,28310,3,28313,0
5676,28311,2,28313,3,28316,1
5677,28317,0,28317,3,28320,0
5678,28319,1,28320,3,28323,1
5677,28320,3,28323,3,28326,1
5679,28324,2,28326,3,28329,1
5678,28326,3,28329,3,28332,1
5680,28328,4,28332,3,28335,2
5681,28332,3,28335,3,28338,1
5681,28338,0,28338,3,28341,0
5682,28338,3,28341,3,28344,1
5681,28341,3,28344,3,28347,1
5683,28345,2,28347,3,28350,1
5684,28351,0,28351,3,28354,0
5685,28357,0,28357,3,28360,0
5685,28360,0,28360,3,28363,0
5686,28362,1,28363,3,28366,1
5687,28366,0,28366,3,28369,0
5688,28370,0,28370,3,28373,0
5688,28373,0,28373,3,28376,0
5689,28377,0,28377,3,28380,0
5690,28381,0,28381,3,28384,0
5691,28383,1,28384,3,28387,1
5690,28384,3,28387,3,28390,1
5692,28392,0,28392,3,28395,0
5693,28395,0,28395,3,28398,0
5693,28398,0,28398,3,28401,0
5694,28400,1,28401,3,28404,1
5695,28405,0,28405,3,28408,0
5696,28411,0,28411,3,28414,0
5697,28417,0,28417,3,28420,0
5698,28422,0,28422,3,28425,0
5699,28425,0,28425,3,28428,0
5700,28430,0,28430,3,28433,0
5701,28440,0,28440,3,28443,0
5701,28443,0,28443,3,28446,0
5702,28445,1,28446,3,28449,1
5701,28446,3,28449,3,28452,1
5703,28451,1,28452,3,28455,1
5704,28453,2,28455,3,28458,1
5705,28458,0,28458,3,28461,0
5706,28462,0,28462,3,28465,0
5707,28466,0,28466,3,28469,0
5708,28472,0,28472,3,28475,0
5709,28476,0,28476,3,28479,0
5710,28481,0,28481,3,28484,0
5710,28484,0,28484,3,28487,0
5711,28488,0,28488,3,28491,0
5712,28495,0,28495,3,28498,0
5712,28498,0,28498,3,28501,0
5713,28501,0,28501,3,28504,0
5714,28504,0,28504,3,28507,0
5715,28507,0,28507,3,28510,0
5716,28513,0,28513,3,28516,0
5717,28516,0,28516,3,28519,0
5718,28517,2,28519,3,28522,1
5717,28519,3,28522,3,28525,1
5719,28522,3,28525,3,28528,1
5720,28526,2,28528,3,28531,1
5719,28528,3,28531,3,28534,1
5721,28529,5,28534,3,28537,2
5722,28535,2,28537,3,28540,1
5723,28539,1,28540,3,28543,1
5722,28540,3,28543,3,28546,1
5722,28543,3,28546,3,28549,1
5722,28546,3,28549,3,28552,1
5724,28548,4,28552,3,28555,2
5725,28555,0,28555,3,28558,0
5725,28558,0,28558,3,28561,0
5726,28561,0,28561,3,28564,0
5727,28564,0,28564,3,28567,0
5728,28568,0,28568,3,28571,0
5729,28571,0,28571,3,28574,0
5730,28576,0,28576,3,28579,0
5730,28579,0,28579,3,28582,0
5731,28579,3,28582,3,28585,1
5732,28584,1,28585,3,28588,1
5733,28585,3,28588,3,28591,1
5734,28586,5,28591,3,28594,2
5732,28588,6,28594,3,28597,2
5735,28590,7,28597,3,28600,3
5736,28595,5,28600,3,28603,2
5737,28597,6,28603,3,28606,2
5738,28599,7,28606,3,28609,3
5739,28602,7,28609,3,28612,3
5740,28604,8,28612,3,28615,3
5741,28608,7,28615,3,28618,3
5738,28609,9,28618,3,28621,3
5742,28614,7,28621,3,28624,3
5743,28617,7,28624,3,28627,3
5740,28618,9,28627,3,28630,3
5744,28622,8,28630,3,28633,3
5741,28624,9,28633,3,28636,3
5745,28625,11,28636,3,28639,4
5746,28628,11,28639,3,28642,4
5747,28634,8,28642,3,28645,3
5748,28641,4,28645,3,28648,2
5746,28642,6,28648,3,28651,2
5749,28648,3,28651,3,28654,1
5750,28653,1,28654,3,28657,1
5751,28659,0,28659,3,28662,0
5751,28662,0,28662,3,28665,0
5752,28663,2,28665,3,28668,1
5753,28667,1,28668,3,28671,1
5754,28677,0,28677,3,28680,0
5755,28683,0,28683,3,28686,0
5756,28686,0,28686,3,28689,0
5757,28692,0,28692,3,28695,0
5758,28696,0,28696,3,28699,0
5759,28699,0,28699,3,28702,0
5760,28706,0,28706,3,28709,0
5761,28710,0,28710,3,28713,0
5761,28713,0,28713,3,28716,0
5762,28719,0,28719,3,28722,0
5763,28729,0,28729,3,28732,0
5763,28732,0,28732,3,28735,0
5764,28732,3,28735,3,28738,1
5765,28738,0,28738,3,28741,0
5766,28741,0,28741,3,28744,0
5767,28746,0,28746,3,28749,0
5768,28750,0,28750,3,28753,0
5769,28755,0,28755,3,28758,0
5770,28756,2,28758,3,28761,1
5771,28759,2,28761,3,28764,1
5772,28762,2,28764,3,28767,1
5773,28766,1,28767,3,28770,1
5772,28767,3,28770,3,28773,1
5773,28773,0,28773,3,28776,0
5774,28775,1,28776,3,28779,1
5775,28778,1,28779,3,28782,1
5776,28787,0,28787,3,28790,0
5777,28792,0,28792,3,28795,0
5778,28795,0,28795,3,28798,0
5779,28801,0,28801,3,28804,0
5780,28807,0,28807,3,28810,0
5781,28814,0,28814,3,28817,0
5782,28820,0,28820,3,28823,0
5782,28823,0,28823,3,28826,0
5782,28826,0,28826,3,28829,0
5783,28827,2,28829,3,28832,1
5784,28830,2,28832,3,28835,1
5785,28833,2,28835,3,28838,1
5785,28838,0,28838,3,28841,0
5786,28839,2,28841,3,28844,1
5787,28844,0,28844,3,28847,0
5787,28847,0,28847,3,28850,0
5788,28849,1,28850,3,28853,1
5788,28853,0,28853,3,28856,0
5789,28854,2,28856,3,28859,1
5790,28860,0,28860,3,28863,0
5791,28863,0,28863,3,28866,0
5792,28869,0,28869,3,28872,0
5793,28874,0,28874,3,28877,0
5794,28878,0,28878,3,28881,0
5794,28881,0,28881,3,28884,0
5795,28884,0,28884,3,28887,0
5796,28887,0,28887,3,28890,0
5797,28892,0,28892,3,28895,0
5798,28900,0,28900,3,28903,0
5799,28906,0,28906,3,28909,0
5800,28908,1,28909,3,28912,1
5801,28912,0,28912,3,28915,0
5802,28913,2,28915,3,28918,1
5803,28919,0,28919,3,28922,0
5804,28926,0,28926,3,28929,0
5805,28932,0,28932,3,28935,0
5806,28937,0,28937,3,28940,0
5807,28945,0,28945,3,28948,0
5807,28948,0,28948,3,28951,0
5808,28949,2,28951,3,28954,1
5808,28954,0,28954,3,28957,0
5809,28955,2,28957,3,28960,1
5810,28965,0,28965,3,28968,0
5811,28970,0,28970,3,28973,0
5812,28977,0,28977,3,28980,0
5813,28983,0,28983,3,28986,0
5813,28986,0,28986,3,28989,0
5814,28986,3,28989,3,28992,1
5815,28989,3,28992,3,28995,1
5814,28992,3,28995,3,28998,1
5816,28996,2,28998,3,29001,1
5817,29000,1,29001,3,29004,1
5818,29005,0,29005,3,29008,0
5819,29013,0,29013,3,29016,0
5820,29017,0,29017,3,29020,0
5821,29025,0,29025,3,29028,0
5822,29030,0,29030,3,29033,0
5823,29034,0,29034,3,29037,0
5824,29039,0,29039,3,29042,0
5825,29043,0,29043,3,29046,0
5825,29046,0,29046,3,29049,0
5826,29049,0,29049,3,29052,0
5827,29050,2,29052,3,29055,1
5827,29055,0,29055,3,29058,0
5828,29057,1,29058,3,29061,1
5829,29059,2,29061,3,29064,1
5830,29064,0,29064,3,29067,0
5831,29071,0,29071,3,29074,0
5832,29079,0,29079,3,29082,0
5832,29082,0,29082,3,29085,0
5833,29086,0,29086,3,29089,0
5834,29089,0,29089,3,29092,0
5835,29094,0,29094,3,29097,0
5835,29097,0,29097,3,29100,0
5836,29098,2,29100,3,29103,1
5836,29103,0,29103,3,29106,0
5837,29105,1,29106,3,29109,1
5836,29106,3,29109,3,29112,1
5838,29111,1,29112,3,29115,1
5839,29114,1,29115,3,29118,1
5840,29119,0,29119,3,29122,0
5841,29123,0,29123,3,29126,0
5841,29126,0,29126,3,29129,0
5842,29127,2,29129,3,29132,1
5842,29132,0,29132,3,29135,0
5843,29133,2,29135,3,29138,1
5844,29135,3,29138,3,29141,1
5845,29138,3,29141,3,29144,1
5845,29144,0,29144,3,29147,0
5846,29144,3,29147,3,29150,1
5847,29146,4,29150,3,29153,2
5848,29152,1,29153,3,29156,1
5848,29156,0,29156,3,29159,0
5849,29159,0,29159,3,29162,0
5850,29162,0,29162,3,29165,0
5851,29170,0,29170,3,29173,0
5852,29175,0,29175,3,29178,0
5853,29181,0,29181,3,29184,0
5854,29185,0,29185,3,29188,0
5855,29196,0,29196,3,29199,0
5855,29199,0,29199,3,29202,0
5856,29201,1,29202,3,29205,1
5856,29205,0,29205,3,29208,0
5857,29205,3,29208,3,29211,1
5858,29209,2,29211,3,29214,1
5859,29214,0,29214,3,29217,0
5860,29224,0,29224,3,29227,0
5861,29226,1,29227,3,29230,1
5862,29228,2,29230,3,29233,1
5863,29231,2,29233,3,29236,1
5864,29238,0,29238,3,29241,0
5865,29241,0,29241,3,29244,0
5866,29246,0,29246,3,29249,0
5867,29252,0,29252,3,29255,0
5867,29255,0,29255,3,29258,0
5868,29255,3,29258,3,29261,1
5869,29258,3,29261,3,29264,1
5870,29259,5,29264,3,29267,2
5871,29261,6,29267,3,29270,2
5872,29268,2,29270,3,29273,1
5873,29272,1,29273,3,29276,1
5874,29275,1,29276,3,29279,1
5873,29276,3,29279,3,29282,1
5873,29279,3,29282,3,29285,1
5875,29280,5,29285,3,29288,2
5876,29283,5,29288,3,29291,2
5877,29290,1,29291,3,29294,1
5878,29293,1,29294,3,29297,1
5877,29294,3,29297,3,29300,1
5878,29300,0,29300,3,29303,0
5879,29305,0,29305,3,29308,0
5880,29309,0,29309,3,29312,0
5880,29312,0,29312,3,29315,0
5880,29315,0,29315,3,29318,0
5881,29316,2,29318,3,29321,1
5882,29319,2,29321,3,29324,1
5883,29330,0,29330,3,29333,0
5884,29333,0,29333,3,29336,0
5885,29335,1,29336,3,29339,1
5886,29336,3,29339,3,29342,1
5885,29339,3,29342,3,29345,1
5887,29341,4,29345,3,29348,2
5888,29346,2,29348,3,29351,1
5888,29351,0,29351,3,29354,0
5889,29354,0,29354,3,29357,0
5890,29355,2,29357,3,29360,1
5890,29360,0,29360,3,29363,0
5891,29360,3,29363,3,29366,1
5892,29362,4,29366,3,29369,2
5890,29363,6,29369,3,29372,2
5893,29364,8,29372,3,29375,3
5894,29367,8,29375,3,29378,3
5895,29371,7,29378,3,29381,3
5896,29375,6,29381,3,29384,2
5894,29378,6,29384,3,29387,2
5897,29378,9,29387,3,29390,3
5894,29381,9,29390,3,29393,3
5894,29384,9,29393,3,29396,3
5898,29386,10,29396,3,29399,4
5894,29387,12,29399,3,29402,4
5899,29393,9,29402,3,29405,3
5900,29394,11,29405,3,29408,4
5901,29394,14,29408,3,29411,5
5896,29396,15,29411,3,29414,5
5896,29399,15,29414,3,29417,5
5902,29400,17,29417,3,29420,6
5903,29402,18,29420,3,29423,6
5904,29405,18,29423,3,29426,6
5905,29408,18,29426,3,29429,6
5899,29411,18,29429,3,29432,6
5906,29413,19,29432,3,29435,7
5900,29417,18,29435,3,29438,6
5907,29418,20,29438,3,29441,7
5908,29423,18,29441,3,29444,6
5909,29429,15,29444,3,29447,5
5904,29432,15,29447,3,29450,5
5910,29434,16,29450,3,29453,6
5904,29435,18,29453,3,29456,6
5911,29435,21,29456,3,29459,7
5904,29438,21,29459,3,29462,7
5904,29441,21,29462,3,29465,7
5912,29445,20,29465,3,29468,7
5913,29452,16,29468,3,29471,6
5914,29454,17,29471,3,29474,6
5915,29459,15,29474,3,29477,5
5916,29461,16,29477,3,29480,6
5910,29462,18,29480,3,29483,6
5917,29466,17,29483,3,29486,6
5911,29468,18,29486,3,29489,6
5918,29473,16,29489,3,29492,6
5912,29474,18,29492,3,29495,6
5919,29478,17,29495,3,29498,6
5913,29480,18,29498,3,29501,6
5920,29482,19,29501,3,29504,7
5914,29486,18,29504,3,29507,6
5914,29489,18,29507,3,29510,6
5921,29490,20,29510,3,29513,7
5922,29493,20,29513,3,29516,7
5915,29495,21,29516,3,29519,7
5923,29495,24,29519,3,29522,8
5924,29498,24,29522,3,29525,8
5925,29502,23,29525,3,29528,8
5926,29505,23,29528,3,29531,8
5920,29513,18,29531,3,29534,6
5927,29513,21,29534,3,29537,7
5928,29515,22,29537,3,29540,8
5929,29519,21,29540,3,29543,7
5930,29525,18,29543,3,29546,6
5931,29528,18,29546,3,29549,6
5926,29534,15,29549,3,29552,5
5932,29535,17,29552,3,29555,6
5926,29537,18,29555,3,29558,6
5933,29537,21,29558,3,29561,7
5926,29540,21,29561,3,29564,7
5926,29543,21,29564,3,29567,7
5934,29543,24,29567,3,29570,8
5935,29549,21,29570,3,29573,7
5936,29557,16,29573,3,29576,6
5937,29560,16,29576,3,29579,6
5932,29564,15,29579,3,29582,5
5932,29567,15,29582,3,29585,5
5938,29567,18,29585,3,29588,6
5939,29575,13,29588,3,29591,5
5940,29579,12,29591,3,29594,4
5941,29584,10,29594,3,29597,4
5942,29587,10,29597,3,29600,4
5943,29591,9,29600,3,29603,3
5944,29594,9,29603,3,29606,3
5945,29600,6,29606,3,29609,2
5946,29602,7,29609,3,29612,3
5944,29606,6,29612,3,29615,2
5947,29606,9,29615,3,29618,3
5948,29610,8,29618,3,29621,3
5949,29614,7,29621,3,29624,3
5950,29618,6,29624,3,29627,2
5948,29621,6,29627,3,29630,2
5951,29622,8,29630,3,29633,3
5952,29623,10,29633,3,29636,4
5953,29628,8,29636,3,29639,3
5954,29630,9,29639,3,29642,3
5951,29633,9,29642,3,29645,3
5955,29634,11,29645,3,29648,4
5956,29636,12,29648,3,29651,4
5957,29638,13,29651,3,29654,5
5952,29639,15,29654,3,29657,5
5958,29640,17,29657,3,29660,6
5953,29645,15,29660,3,29663,5
5959,29645,18,29663,3,29666,6
5960,29650,16,29666,3,29669,6
5961,29653,16,29669,3,29672,6
5962,29659,13,29672,3,29675,5
5963,29663,12,29675,3,29678,4
5964,29664,14,29678,3,29681,5
5965,29671,10,29681,3,29684,4
5963,29678,6,29684,3,29687,2
5966,29680,7,29687,3,29690,3
5964,29684,6,29690,3,29693,2
5967,29684,9,29693,3,29696,3
5968,29691,5,29696,3,29699,2
5966,29693,6,29699,3,29702,2
5966,29696,6,29702,3,29705,2
5969,29696,9,29705,3,29708,3
5970,29700,8,29708,3,29711,3
5971,29707,4,29711,3,29714,2
5969,29708,6,29714,3,29717,2
5972,29717,0,29717,3,29720,0
5973,29719,1,29720,3,29723,1
5973,29723,0,29723,3,29726,0
5974,29723,3,29726,3,29729,1
5973,29726,3,29729,3,29732,1
5975,29727,5,29732,3,29735,2
5976,29728,7,29735,3,29738,3
5977,29731,7,29738,3,29741,3
5975,29735,6,29741,3,29744,2
5978,29736,8,29744,3,29747,3
5975,29738,9,29747,3,29750,3
5975,29741,9,29750,3,29753,3
5979,29741,12,29753,3,29756,4
5980,29745,11,29756,3,29759,4
5981,29747,12,29759,3,29762,4
5977,29750,12,29762,3,29765,4
5982,29753,12,29765,3,29768,4
5983,29757,11,29768,3,29771,4
5984,29766,5,29771,3,29774,2
5985,29770,4,29774,3,29777,2
5985,29777,0,29777,3,29780,0
5986,29779,1,29780,3,29783,1
5987,29783,0,29783,3,29786,0
5987,29786,0,29786,3,29789,0
5988,29788,1,29789,3,29792,1
5988,29792,0,29792,3,29795,0
5989,29793,2,29795,3,29798,1
5988,29795,3,29798,3,29801,1
5990,29799,2,29801,3,29804,1
5991,29803,1,29804,3,29807,1
5990,29804,3,29807,3,29810,1
5990,29807,3,29810,3,29813,1
5992,29809,4,29813,3,29816,2
5993,29812,4,29816,3,29819,2
5991,29813,6,29819,3,29822,2
5994,29816,6,29822,3,29825,2
5992,29819,6,29825,3,29828,2
5995,29822,6,29828,3,29831,2
5996,29825,6,29831,3,29834,2
5997,29827,7,29834,3,29837,3
5998,29832,5,29837,3,29840,2
5997,29837,3,29840,3,29843,1
5999,29840,3,29843,3,29846,1
5998,29843,3,29846,3,29849,1
5998,29846,3,29849,3,29852,1
6000,29847,5,29852,3,29855,2
6001,29851,4,29855,3,29858,2
6002,29855,3,29858,3,29861,1
6001,29858,3,29861,3,29864,1
6003,29861,3,29864,3,29867,1
6004,29867,0,29867,3,29870,0
6004,29870,0,29870,3,29873,0
6004,29873,0,29873,3,29876,0
6005,29882,0,29882,3,29885,0
6005,29885,0,29885,3,29888,0
6006,29887,1,29888,3,29891,1
6005,29888,3,29891,3,29894,1
6007,29889,5,29894,3,29897,2
6008,29895,2,29897,3,29900,1
6009,29902,0,29902,3,29905,0
6010,29905,0,29905,3,29908,0
6011,29911,0,29911,3,29914,0
6012,29916,0,29916,3,29919,0
6013,29917,2,29919,3,29922,1
6012,29919,3,29922,3,29925,1
6014,29921,4,29925,3,29928,2
6012,29922,6,29928,3,29931,2
6012,29925,6,29931,3,29934,2
6015,29929,5,29934,3,29937,2
6016,29935,2,29937,3,29940,1
6017,29945,0,29945,3,29948,0
6018,29946,2,29948,3,29951,1
6017,29948,3,29951,3,29954,1
6019,29953,1,29954,3,29957,1
6020,29959,0,29959,3,29962,0
6021,29963,0,29963,3,29966,0
6022,29971,0,29971,3,29974,0
6023,29974,0,29974,3,29977,0
6024,29977,0,29977,3,29980,0
6025,29983,0,29983,3,29986,0
6026,29986,0,29986,3,29989,0
6027,29992,0,29992,3,29995,0
6027,29995,0,29995,3,29998,0
6028,29997,1,29998,3,30001,1
6027,29998,3,30001,3,30004,1
6029,30001,3,30004,3,30007,1
6028,30004,3,30007,3,30010,1
6030,30010,0,30010,3,30013,0
6031,30014,0,30014,3,30017,0
6032,30018,0,30018,3,30021,0
6032,30021,0,30021,3,30024,0
6033,30021,3,30024,3,30027,1
6034,30025,2,30027,3,30030,1
6033,30027,3,30030,3,30033,1
6033,30030,3,30033,3,30036,1
6035,30032,4,30036,3,30039,2
6036,30035,4,30039,3,30042,2
6034,30036,6,30042,3,30045,2
6037,30040,5,30045,3,30048,2
6038,30046,2,30048,3,30051,1
6039,30049,2,30051,3,30054,1
6038,30051,3,30054,3,30057,1
6038,30054,3,30057,3,30060,1
6040,30055,5,30060,3,30063,2
6038,30057,6,30063,3,30066,2
6041,30059,7,30066,3,30069,3
6042,30062,7,30069,3,30072,3
6043,30064,8,30072,3,30075,3
6040,30066,9,30075,3,30078,3
6040,30069,9,30078,3,30081,3
6044,30070,11,30081,3,30084,4
6045,30073,11,30084,3,30087,4
6046,30077,10,30087,3,30090,4
6047,30084,6,30090,3,30093,2
6046,30090,3,30093,3,30096,1
6048,30094,2,30096,3,30099,1
6049,30101,0,30101,3,30104,0
6050,30106,0,30106,3,30109,0
6051,30109,0,30109,3,30112,0
6052,30112,0,30112,3,30115,0
6053,30124,0,30124,3,30127,0
6054,30126,1,30127,3,30130,1
6054,30130,0,30130,3,30133,0
6054,30133,0,30133,3,30136,0
6055,30134,2,30136,3,30139,1
6056,30140,0,30140,3,30143,0
6056,30143,0,30143,3,30146,0
6057,30144,2,30146,3,30149,1
6056,30146,3,30149,3,30152,1
6058,30148,4,30152,3,30155,2
6058,30155,0,30155,3,30158,0
6059,30156,2,30158,3,30161,1
6060,30162,0,30162,3,30165,0
6061,30167,0,30167,3,30170,0
6061,30170,0,30170,3,30173,0
6061,30173,0,30173,3,30176,0
6062,30173,3,30176,3,30179,1
6063,30175,4,30179,3,30182,2
6064,30180,2,30182,3,30185,1
6063,30182,3,30185,3,30188,1
6065,30183,5,30188,3,30191,2
6063,30185,6,30191,3,30194,2
6063,30188,6,30194,3,30197,2
6066,30188,9,30197,3,30200,3
6067,30191,9,30200,3,30203,3
6068,30198,5,30203,3,30206,2
6069,30205,1,30206,3,30209,1
6070,30214,0,30214,3,30217,0
6070,30217,0,30217,3,30220,0
6071,30218,2,30220,3,30223,1
6072,30224,0,30224,3,30227,0
6073,30231,0,30231,3,30234,0
6074,30236,0,30236,3,30239,0
6075,30245,0,30245,3,30248,0
6076,30250,0,30250,3,30253,0
6077,30252,1,30253,3,30256,1
6078,30257,0,30257,3,30260,0
6079,30258,2,30260,3,30263,1
6078,30260,3,30263,3,30266,1
6080,30262,4,30266,3,30269,2
6081,30265,4,30269,3,30272,2
6079,30266,6,30272,3,30275,2
6082,30270,5,30275,3,30278,2
6080,30272,6,30278,3,30281,2
6083,30275,6,30281,3,30284,2
6081,30278,6,30284,3,30287,2
6084,30279,8,30287,3,30290,3
6081,30281,9,30290,3,30293,3
6085,30283,10,30293,3,30296,4
6081,30284,12,30296,3,30299,4
6086,30288,11,30299,3,30302,4
6087,30291,11,30302,3,30305,4
6088,30296,9,30305,3,30308,3
6086,30302,6,30308,3,30311,2
6089,30303,8,30311,3,30314,3
6087,30308,6,30314,3,30317,2
6090,30316,1,30317,3,30320,1
6091,30326,0,30326,3,30329,0
6092,30330,0,30330,3,30333,0
6093,30338,0,30338,3,30341,0
6094,30344,0,30344,3,30347,0
6095,30350,0,30350,3,30353,0
6096,30358,0,30358,3,30361,0
6097,30363,0,30363,3,30366,0
6097,30366,0,30366,3,30369,0
6098,30367,2,30369,3,30372,1
6099,30371,1,30372,3,30375,1
6100,30377,0,30377,3,30380,0
6100,30380,0,30380,3,30383,0
6101,30380,3,30383,3,30386,1
6102,30384,2,30386,3,30389,1
6101,30386,3,30389,3,30392,1
6103,30388,4,30392,3,30395,2
6104,30398,0,30398,3,30401,0
6105,30404,0,30404,3,30407,0
6106,30406,1,30407,3,30410,1
6107,30411,0,30411,3,30414,0
6107,30414,0,30414,3,30417,0
6108,30415,2,30417,3,30420,1
6109,30419,1,30420,3,30423,1
6110,30424,0,30424,3,30427,0
6111,30426,1,30427,3,30430,1
6112,30431,0,30431,3,30434,0
6112,30434,0,30434,3,30437,0
6113,30434,3,30437,3,30440,1
6114,30439,1,30440,3,30443,1
6115,30444,0,30444,3,30447,0
6115,30447,0,30447,3,30450,0
6116,30453,0,30453,3,30456,0
6117,30458,0,30458,3,30461,0
6118,30462,0,30462,3,30465,0
6118,30465,0,30465,3,30468,0
6118,30468,0,30468,3,30471,0
6119,30468,3,30471,3,30474,1
6120,30470,4,30474,3,30477,2
6121,30473,4,30477,3,30480,2
6122,30480,0,30480,3,30483,0
6122,30483,0,30483,3,30486,0
6123,30485,1,30486,3,30489,1
6124,30492,0,30492,3,30495,0
6125,30500,0,30500,3,30503,0
6126,30511,0,30511,3,30514,0
6126,30514,0,30514,3,30517,0
6127,30515,2,30517,3,30520,1
6128,30519,1,30520,3,30523,1
6129,30522,1,30523,3,30526,1
6128,30523,3,30526,3,30529,1
6128,30526,3,30529,3,30532,1
6130,30527,5,30532,3,30535,2
6131,30529,6,30535,3,30538,2
6129,30532,6,30538,3,30541,2
6132,30533,8,30541,3,30544,3
6130,30538,6,30544,3,30547,2
6133,30538,9,30547,3,30550,3
6134,30542,8,30550,3,30553,3
6133,30550,3,30553,3,30556,1
6135,30550,6,30556,3,30559,2
6133,30553,6,30559,3,30562,2
6136,30559,3,30562,3,30565,1
6137,30562,3,30565,3,30568,1
6137,30568,0,30568,3,30571,0
6138,30568,3,30571,3,30574,1
6139,30570,4,30574,3,30577,2
6140,30573,4,30577,3,30580,2
6141,30582,0,30582,3,30585,0
6142,30588,0,30588,3,30591,0
6143,30593,0,30593,3,30596,0
6144,30598,0,30598,3,30601,0
6144,30601,0,30601,3,30604,0
6145,30605,0,30605,3,30608,0
6146,30609,0,30609,3,30612,0
6146,30612,0,30612,3,30615,0
6147,30614,1,30615,3,30618,1
6147,30618,0,30618,3,30621,0
6148,30618,3,30621,3,30624,1
6147,30621,3,30624,3,30627,1
6147,30624,3,30627,3,30630,1
6147,30627,3,30630,3,30633,1
6149,30628,5,30633,3,30636,2
6150,30631,5,30636,3,30639,2
6148,30633,6,30639,3,30642,2
6148,30636,6,30642,3,30645,2
6151,30637,8,30645,3,30648,3
6152,30641,7,30648,3,30651,3
6153,30647,4,30651,3,30654,2
6151,30648,6,30654,3,30657,2
6154,30653,4,30657,3,30660,2
6155,30657,3,30660,3,30663,1
6156,30661,2,30663,3,30666,1
6155,30663,3,30666,3,30669,1
6155,30666,3,30669,3,30672,1
6155,30669,3,30672,3,30675,1
6157,30670,5,30675,3,30678,2
6155,30672,6,30678,3,30681,2
6158,30674,7,30681,3,30684,3
6155,30675,9,30684,3,30687,3
6159,30675,12,30687,3,30690,4
6160,30683,7,30690,3,30693,3
6161,30688,5,30693,3,30696,2
6162,30689,7,30696,3,30699,3
6163,30696,3,30699,3,30702,1
6164,30700,2,30702,3,30705,1
6163,30702,3,30705,3,30708,1
6165,30706,2,30708,3,30711,1
6164,30708,3,30711,3,30714,1
6166,30712,2,30714,3,30717,1
6167,30721,0,30721,3,30724,0
6167,30724,0,30724,3,30727,0
6168,30726,1,30727,3,30730,1
6169,30726,4,30730,3,30733,2
6170,30732,1,30733,3,30736,1
6169,30733,3,30736,3,30739,1
6169,30736,3,30739,3,30742,1
6171,30738,4,30742,3,30745,2
6172,30744,1,30745,3,30748,1
6173,30748,0,30748,3,30751,0
6174,30754,0,30754,3,30757,0
6174,30757,0,30757,3,30760,0
6175,30762,0,30762,3,30765,0
6176,30766,0,30766,3,30769,0
6177,30772,0,30772,3,30775,0
6178,30777,0,30777,3,30780,0
6179,30784,0,30784,3,30787,0
6180,30785,2,30787,3,30790,1
6181,30787,3,30790,3,30793,1
6181,30793,0,30793,3,30796,0
6182,30793,3,30796,3,30799,1
6183,30798,1,30799,3,30802,1
6182,30799,3,30802,3,30805,1
6184,30801,4,30805,3,30808,2
6185,30804,4,30808,3,30811,2
6183,30805,6,30811,3,30814,2
6183,30808,6,30814,3,30817,2
6186,30811,6,30817,3,30820,2
6184,30814,6,30820,3,30823,2
6187,30819,4,30823,3,30826,2
6185,30820,6,30826,3,30829,2
6188,30823,6,30829,3,30832,2
6187,30829,3,30832,3,30835,1
6189,30829,6,30835,3,30838,2
6187,30832,6,30838,3,30841,2
6190,30832,9,30841,3,30844,3
6191,30834,10,30844,3,30847,4
6192,30839,8,30847,3,30850,3
6193,30843,7,30850,3,30853,3
6191,30847,6,30853,3,30856,2
6194,30848,8,30856,3,30859,3
6195,30853,6,30859,3,30862,2
6193,30856,6,30862,3,30865,2
6196,30857,8,30865,3,30868,3
6193,30859,9,30868,3,30871,3
6197,30860,11,30871,3,30874,4
6198,30861,13,30874,3,30877,5
6199,30870,7,30877,3,30880,3
6197,30874,6,30880,3,30883,2
6200,30874,9,30883,3,30886,3
6201,30876,10,30886,3,30889,4
6202,30876,13,30889,3,30892,5
6197,30877,15,30892,3,30895,5
6203,30877,18,30895,3,30898,6
6204,30883,15,30898,3,30901,5
6200,30889,12,30901,3,30904,4
6205,30890,14,30904,3,30907,5
6201,30895,12,30907,3,30910,4
6206,30899,11,30910,3,30913,4
6202,30901,12,30913,3,30916,4
6202,30904,12,30916,3,30919,4
6202,30907,12,30919,3,30922,4
6207,30907,15,30922,3,30925,5
6202,30910,15,30925,3,30928,5
6202,30913,15,30928,3,30931,5
6208,30916,15,30931,3,30934,5
6204,30922,12,30934,3,30937,4
6209,30922,15,30937,3,30940,5
6205,30928,12,30940,3,30943,4
6210,30931,12,30943,3,30946,4
6206,30934,12,30946,3,30949,4
6211,30936,13,30949,3,30952,5
6212,30941,11,30952,3,30955,4
6213,30941,14,30955,3,30958,5
6208,30943,15,30958,3,30961,5
6208,30946,15,30961,3,30964,5
6214,30947,17,30964,3,30967,6
6208,30949,18,30967,3,30970,6
6215,30951,19,30970,3,30973,7
6216,30956,17,30973,3,30976,6
6217,30959,17,30976,3,30979,6
6218,30962,17,30979,3,30982,6
6219,30966,16,30982,3,30985,6
6214,30970,15,30985,3,30988,5
6220,30970,18,30988,3,30991,6
6221,30974,17,30991,3,30994,6
6222,30980,14,30994,3,30997,5
6217,30982,15,30997,3,31000,5
6223,30984,16,31000,3,31003,6
6224,30986,17,31003,3,31006,6
6225,30987,19,31006,3,31009,7
6226,30994,15,31009,3,31012,5
6227,30995,17,31012,3,31015,6
6228,30997,18,31015,3,31018,6
6229,31003,15,31018,3,31021,5
6224,31006,15,31021,3,31024,5
6224,31009,15,31024,3,31027,5
6230,31010,17,31027,3,31030,6
6231,31013,17,31030,3,31033,6
6225,31015,18,31033,3,31036,6
6232,31019,17,31036,3,31039,6
6227,31024,15,31039,3,31042,5
6233,31024,18,31042,3,31045,6
6227,31027,18,31045,3,31048,6
6234,31027,21,31048,3,31051,7
6235,31032,19,31051,3,31054,7
6229,31036,18,31054,3,31057,6
6236,31040,17,31057,3,31060,6
6237,31042,18,31060,3,31063,6
6238,31047,16,31063,3,31066,6
6239,31051,15,31066,3,31069,5
6240,31057,12,31069,3,31072,4
6241,31063,9,31072,3,31075,3
6242,31065,10,31075,3,31078,4
6238,31066,12,31078,3,31081,4
6243,31071,10,31081,3,31084,4
6239,31072,12,31084,3,31087,4
6244,31079,8,31087,3,31090,3
6241,31081,9,31090,3,31093,3
6245,31083,10,31093,3,31096,4
6242,31087,9,31096,3,31099,3
6246,31087,12,31099,3,31102,4
6247,31095,7,31102,3,31105,3
6248,31099,6,31105,3,31108,2
6249,31105,3,31108,3,31111,1
6250,31110,1,31111,3,31114,1
6251,31113,1,31114,3,31117,1
6250,31114,3,31117,3,31120,1
6252,31121,0,31121,3,31124,0
6253,31125,0,31125,3,31128,0
6253,31128,0,31128,3,31131,0
6253,31131,0,31131,3,31134,0
6254,31133,1,31134,3,31137,1
6255,31138,0,31138,3,31141,0
6256,31142,0,31142,3,31145,0
6257,31150,0,31150,3,31153,0
6258,31153,0,31153,3,31156,0
6258,31156,0,31156,3,31159,0
6259,31157,2,31159,3,31162,1
6258,31159,3,31162,3,31165,1
6260,31159,6,31165,3,31168,2
6261,31164,4,31168,3,31171,2
6260,31168,3,31171,3,31174,1
6262,31169,5,31174,3,31177,2
6263,31174,3,31177,3,31180,1
6264,31184,0,31184,3,31187,0
6265,31191,0,31191,3,31194,0
6266,31195,0,31195,3,31198,0
6266,31198,0,31198,3,31201,0
6267,31201,0,31201,3,31204,0
6267,31204,0,31204,3,31207,0
6268,31206,1,31207,3,31210,1
6268,31210,0,31210,3,31213,0
6269,31212,1,31213,3,31216,1
6268,31213,3,31216,3,31219,1
6268,31216,3,31219,3,31222,1
6270,31218,4,31222,3,31225,2
6271,31221,4,31225,3,31228,2
6269,31222,6,31228,3,31231,2
6272,31224,7,31231,3,31234,3
6271,31231,3,31234,3,31237,1
6273,31231,6,31237,3,31240,2
6274,31231,9,31240,3,31243,3
6275,31236,7,31243,3,31246,3
6274,31243,3,31246,3,31249,1
6276,31244,5,31249,3,31252,2
6277,31249,3,31252,3,31255,1
6278,31253,2,31255,3,31258,1
6279,31262,0,31262,3,31265,0
6280,31267,0,31267,3,31270,0
6280,31270,0,31270,3,31273,0
6281,31270,3,31273,3,31276,1
6280,31273,3,31276,3,31279,1
6282,31274,5,31279,3,31282,2
6283,31280,2,31282,3,31285,1
6284,31283,2,31285,3,31288,1
6283,31285,3,31288,3,31291,1
6285,31291,0,31291,3,31294,0
6286,31293,1,31294,3,31297,1
6287,31297,0,31297,3,31300,0
6287,31300,0,31300,3,31303,0
6288,31300,3,31303,3,31306,1
6287,31303,3,31306,3,31309,1
6289,31303,6,31309,3,31312,2
6290,31308,4,31312,3,31315,2
6291,31310,5,31315,3,31318,2
6289,31312,6,31318,3,31321,2
6292,31313,8,31321,3,31324,3
6293,31318,6,31324,3,31327,2
6291,31321,6,31327,3,31330,2
6291,31324,6,31330,3,31333,2
6291,31327,6,31333,3,31336,2
6294,31327,9,31336,3,31339,3
6295,31329,10,31339,3,31342,4
6296,31331,11,31342,3,31345,4
6297,31334,11,31345,3,31348,4
6293,31336,12,31348,3,31351,4
6293,31339,12,31351,3,31354,4
6298,31341,13,31354,3,31357,5
6294,31345,12,31357,3,31360,4
6299,31346,14,31360,3,31363,5
6294,31348,15,31363,3,31366,5
6294,31351,15,31366,3,31369,5
6294,31354,15,31369,3,31372,5
6300,31354,18,31372,3,31375,6
6294,31357,18,31375,3,31378,6
6301,31358,20,31378,3,31381,7
6302,31365,16,31381,3,31384,6
6296,31366,18,31384,3,31387,6
6296,31369,18,31387,3,31390,6
6303,31370,20,31390,3,31393,7
6304,31371,22,31393,3,31396,8
6296,31372,24,31396,3,31399,8
6305,31377,22,31399,3,31402,8
6306,31380,22,31402,3,31405,8
6298,31381,24,31405,3,31408,8
6307,31386,22,31408,3,31411,8
6308,31387,24,31411,3,31414,8
6309,31395,19,31414,3,31417,7
6310,31402,15,31417,3,31420,5
6305,31405,15,31420,3,31423,5
6311,31407,16,31423,3,31426,6
6312,31414,12,31426,3,31429,4
6313,31419,10,31429,3,31432,4
6314,31422,10,31432,3,31435,4
6315,31428,7,31435,3,31438,3
6313,31432,6,31438,3,31441,2
6316,31433,8,31441,3,31444,3
6313,31435,9,31444,3,31447,3
6317,31439,8,31447,3,31450,3
6318,31447,3,31450,3,31453,1
6317,31450,3,31453,3,31456,1
6319,31450,6,31456,3,31459,2
6320,31452,7,31459,3,31462,3
6317,31453,9,31462,3,31465,3
6317,31456,9,31465,3,31468,3
6321,31460,8,31468,3,31471,3
6322,31464,7,31471,3,31474,3
6320,31468,6,31474,3,31477,2
6323,31471,6,31477,3,31480,2
6321,31474,6,31480,3,31483,2
6324,31477,6,31483,3,31486,2
6324,31486,0,31486,3,31489,0
6325,31486,3,31489,3,31492,1
6326,31493,0,31493,3,31496,0
6327,31495,1,31496,3,31499,1
6327,31499,0,31499,3,31502,0
6327,31502,0,31502,3,31505,0
6328,31505,0,31505,3,31508,0
6328,31508,0,31508,3,31511,0
6329,31510,1,31511,3,31514,1
6330,31517,0,31517,3,31520,0
6331,31519,1,31520,3,31523,1
6332,31527,0,31527,3,31530,0
6332,31530,0,31530,3,31533,0
6333,31533,0,31533,3,31536,0
6334,31534,2,31536,3,31539,1
6333,31536,3,31539,3,31542,1
6333,31539,3,31542,3,31545,1
6335,31540,5,31545,3,31548,2
6333,31542,6,31548,3,31551,2
6334,31548,3,31551,3,31554,1
6336,31550,4,31554,3,31557,2
6334,31551,6,31557,3,31560,2
6337,31556,4,31560,3,31563,2
6335,31557,6,31563,3,31566,2
6335,31560,6,31566,3,31569,2
6338,31560,9,31569,3,31572,3
6337,31569,3,31572,3,31575,1
6337,31572,3,31575,3,31578,1
6339,31572,6,31578,3,31581,2
6340,31577,4,31581,3,31584,2
6341,31583,1,31584,3,31587,1
6342,31587,0,31587,3,31590,0
6342,31590,0,31590,3,31593,0
6343,31591,2,31593,3,31596,1
6344,31597,0,31597,3,31600,0
6345,31600,0,31600,3,31603,0
6346,31604,0,31604,3,31607,0
6347,31608,0,31608,3,31611,0
6347,31611,0,31611,3,31614,0
6348,31614,0,31614,3,31617,0
6349,31619,0,31619,3,31622,0
6350,31621,1,31622,3,31625,1
6351,31625,0,31625,3,31628,0
6352,31630,0,31630,3,31633,0
6353,31634,0,31634,3,31637,0
6354,31637,0,31637,3,31640,0
6355,31641,0,31641,3,31644,0
6356,31646,0,31646,3,31649,0
6357,31658,0,31658,3,31661,0
6358,31665,0,31665,3,31668,0
6359,31672,0,31672,3,31675,0
6359,31675,0,31675,3,31678,0
6360,31677,1,31678,3,31681,1
6361,31678,3,31681,3,31684,1
6360,31681,3,31684,3,31687,1
6362,31682,5,31687,3,31690,2
6361,31687,3,31690,3,31693,1
6363,31688,5,31693,3,31696,2
6361,31690,6,31696,3,31699,2
6364,31699,0,31699,3,31702,0
6365,31704,0,31704,3,31707,0
6366,31709,0,31709,3,31712,0
6367,31716,0,31716,3,31719,0
6368,31718,1,31719,3,31722,1
6369,31729,0,31729,3,31732,0
6369,31732,0,31732,3,31735,0
6370,31735,0,31735,3,31738,0
6371,31738,0,31738,3,31741,0
6372,31739,2,31741,3,31744,1
6371,31741,3,31744,3,31747,1
6373,31743,4,31747,3,31750,2
6374,31747,3,31750,3,31753,1
6375,31749,4,31753,3,31756,2
6373,31750,6,31756,3,31759,2
6376,31754,5,31759,3,31762,2
6374,31756,6,31762,3,31765,2
6377,31764,1,31765,3,31768,1
6378,31771,0,31771,3,31774,0
6379,31773,1,31774,3,31777,1
6380,31776,1,31777,3,31780,1
6381,31779,1,31780,3,31783,1
6382,31782,1,31783,3,31786,1
6382,31786,0,31786,3,31789,0
6383,31788,1,31789,3,31792,1
6384,31799,0,31799,3,31802,0
6385,31801,1,31802,3,31805,1
6384,31802,3,31805,3,31808,1
6384,31805,3,31808,3,31811,1
6386,31805,6,31811,3,31814,2
6384,31808,6,31814,3,31817,2
6384,31811,6,31817,3,31820,2
6387,31811,9,31820,3,31823,3
6388,31813,10,31823,3,31826,4
6384,31814,12,31826,3,31829,4
6389,31817,12,31829,3,31832,4
6390,31821,11,31832,3,31835,4
6391,31829,6,31835,3,31838,2
6392,31834,4,31838,3,31841,2
6393,31841,0,31841,3,31844,0
6394,31847,0,31847,3,31850,0
6395,31853,0,31853,3,31856,0
6396,31857,0,31857,3,31860,0
6396,31860,0,31860,3,31863,0
6397,31860,3,31863,3,31866,1
6396,31863,3,31866,3,31869,1
6398,31864,5,31869,3,31872,2
6399,31869,3,31872,3,31875,1
6400,31872,3,31875,3,31878,1
6401,31876,2,31878,3,31881,1
6402,31880,1,31881,3,31884,1
6402,31884,0,31884,3,31887,0
6403,31886,1,31887,3,31890,1
6404,31886,4,31890,3,31893,2
6405,31890,3,31893,3,31896,1
6404,31893,3,31896,3,31899,1
6406,31897,2,31899,3,31902,1
6405,31899,3,31902,3,31905,1
6407,31901,4,31905,3,31908,2
6406,31905,3,31908,3,31911,1
6408,31906,5,31911,3,31914,2
6406,31908,6,31914,3,31917,2
6409,31911,6,31917,3,31920,2
6407,31914,6,31920,3,31923,2
6410,31917,6,31923,3,31926,2
6411,31925,1,31926,3,31929,1
6410,31926,3,31929,3,31932,1
6412,31930,2,31932,3,31935,1
6413,31934,1,31935,3,31938,1
6412,31935,3,31938,3,31941,1
6414,31939,2,31941,3,31944,1
6415,31944,0,31944,3,31947,0
6415,31947,0,31947,3,31950,0
6416,31950,0,31950,3,31953,0
6417,31953,0,31953,3,31956,0
6418,31957,0,31957,3,31960,0
6419,31961,0,31961,3,31964,0
6420,31965,0,31965,3,31968,0
6420,31968,0,31968,3,31971,0
6421,31968,3,31971,3,31974,1
6420,31971,3,31974,3,31977,1
6422,31975,2,31977,3,31980,1
6423,31981,0,31981,3,31984,0
6424,31987,0,31987,3,31990,0
6425,31995,0,31995,3,31998,0
6426,31998,0,31998,3,32001,0
6426,32001,0,32001,3,32004,0
6427,32002,2,32004,3,32007,1
6428,32009,0,32009,3,32012,0
6428,32012,0,32012,3,32015,0
6429,32015,0,32015,3,32018,0
6430,32017,1,32018,3,32021,1
6431,32020,1,32021,3,32024,1
6430,32021,3,32024,3,32027,1
6432,32029,0,32029,3,32032,0
6433,32036,0,32036,3,32039,0
6434,32040,0,32040,3,32043,0
6434,32043,0,32043,3,32046,0
6435,32044,2,32046,3,32049,1
6435,32049,0,32049,3,32052,0
6436,32049,3,32052,3,32055,1
6437,32054,1,32055,3,32058,1
6438,32059,0,32059,3,32062,0
6439,32066,0,32066,3,32069,0
6439,32069,0,32069,3,32072,0
6440,32070,2,32072,3,32075,1
6441,32077,0,32077,3,32080,0
6442,32079,1,32080,3,32083,1
6443,32087,0,32087,3,32090,0
6444,32093,0,32093,3,32096,0
6444,32096,0,32096,3,32099,0
6445,32098,1,32099,3,32102,1
6444,32099,3,32102,3,32105,1
6444,32102,3,32105,3,32108,1
6446,32104,4,32108,3,32111,2
6446,32111,0,32111,3,32114,0
6447,32112,2,32114,3,32117,1
6447,32117,0,32117,3,32120,0
6448,32117,3,32120,3,32123,1
6448,32123,0,32123,3,32126,0
6449,32123,3,32126,3,32129,1
6450,32124,5,32129,3,32132,2
6451,32131,1,32132,3,32135,1
6450,32132,3,32135,3,32138,1
6450,32135,3,32138,3,32141,1
6452,32135,6,32141,3,32144,2
6453,32136,8,32144,3,32147,3
6450,32138,9,32147,3,32150,3
6454,32141,9,32150,3,32153,3
6455,32146,7,32153,3,32156,3
6456,32150,6,32156,3,32159,2
6454,32153,6,32159,3,32162,2
6457,32153,9,32162,3,32165,3
6458,32157,8,32165,3,32168,3
6455,32159,9,32168,3,32171,3
6459,32162,9,32171,3,32174,3
6460,32168,6,32174,3,32177,2
6461,32175,2,32177,3,32180,1
6460,32177,3,32180,3,32183,1
6462,32181,2,32183,3,32186,1
6463,32184,2,32186,3,32189,1
6462,32186,3,32189,3,32192,1
6462,32189,3,32192,3,32195,1
6464,32192,3,32195,3,32198,1
6465,32199,0,32199,3,32202,0
6465,32202,0,32202,3,32205,0
6466,32203,2,32205,3,32208,1
6467,32209,0,32209,3,32212,0
6468,32215,0,32215,3,32218,0
6468,32218,0,32218,3,32221,0
6469,32225,0,32225,3,32228,0
6470,32231,0,32231,3,32234,0
6470,32234,0,32234,3,32237,0
6471,32237,0,32237,3,32240,0
6472,32243,0,32243,3,32246,0
6473,32247,0,32247,3,32250,0
6473,32250,0,32250,3,32253,0
6474,32251,2,32253,3,32256,1
6475,32255,1,32256,3,32259,1
6476,32262,0,32262,3,32265,0
6477,32268,0,32268,3,32271,0
6478,32273,0,32273,3,32276,0
6479,32274,2,32276,3,32279,1
6480,32280,0,32280,3,32283,0
6481,32284,0,32284,3,32287,0
6482,32287,0,32287,3,32290,0
6483,32291,0,32291,3,32294,0
6484,32295,0,32295,3,32298,0
6485,32302,0,32302,3,32305,0
6486,32306,0,32306,3,32309,0
6487,32311,0,32311,3,32314,0
6487,32314,0,32314,3,32317,0
6488,32316,1,32317,3,32320,1
6489,32320,0,32320,3,32323,0
6490,32321,2,32323,3,32326,1
6491,32325,1,32326,3,32329,1
6490,32326,3,32329,3,32332,1
6492,32327,5,32332,3,32335,2
6490,32329,6,32335,3,32338,2
6493,32330,8,32338,3,32341,3
6494,32333,8,32341,3,32344,3
6495,32341,3,32344,3,32347,1
6496,32350,0,32350,3,32353,0
6497,32354,0,32354,3,32357,0
6498,32357,0,32357,3,32360,0
6499,32364,0,32364,3,32367,0
6499,32367,0,32367,3,32370,0
6500,32370,0,32370,3,32373,0
6501,32374,0,32374,3,32377,0
6502,32377,0,32377,3,32380,0
6502,32380,0,32380,3,32383,0
6503,32383,0,32383,3,32386,0
6503,32386,0,32386,3,32389,0
6504,32391,0,32391,3,32394,0
6504,32394,0,32394,3,32397,0
6505,32401,0,32401,3,32404,0
6506,32407,0,32407,3,32410,0
6507,32414,0,32414,3,32417,0
6507,32417,0,32417,3,32420,0
6508,32418,2,32420,3,32423,1
6508,32423,0,32423,3,32426,0
6509,32425,1,32426,3,32429,1
6509,32429,0,32429,3,32432,0
6510,32430,2,32432,3,32435,1
6511,32435,0,32435,3,32438,0
6512,32442,0,32442,3,32445,0
6512,32445,0,32445,3,32448,0
6513,32447,1,32448,3,32451,1
6514,32451,0,32451,3,32454,0
6515,32456,0,32456,3,32459,0
6515,32459,0,32459,3,32462,0
6516,32460,2,32462,3,32465,1
6515,32462,3,32465,3,32468,1
6515,32465,3,32468,3,32471,1
6517,32466,5,32471,3,32474,2
6518,32472,2,32474,3,32477,1
6519,32477,0,32477,3,32480,0
6520,32485,0,32485,3,32488,0
6521,32491,0,32491,3,32494,0
6522,32496,0,32496,3,32499,0
6523,32499,0,32499,3,32502,0
6524,32507,0,32507,3,32510,0
6525,32510,0,32510,3,32513,0
6526,32515,0,32515,3,32518,0
6527,32517,1,32518,3,32521,1
6528,32523,0,32523,3,32526,0
6529,32530,0,32530,3,32533,0
6530,32532,1,32533,3,32536,1
6530,32536,0,32536,3,32539,0
6531,32538,1,32539,3,32542,1
6531,32542,0,32542,3,32545,0
6532,32548,0,32548,3,32551,0
6533,32551,0,32551,3,32554,0
6534,32556,0,32556,3,32559,0
6535,32558,1,32559,3,32562,1
6536,32561,1,32562,3,32565,1
6537,32566,0,32566,3,32569,0
6538,32568,1,32569,3,32572,1
6538,32572,0,32572,3,32575,0
6539,32573,2,32575,3,32578,1
6538,32575,3,32578,3,32581,1
6540,32579,2,32581,3,32584,1
6541,32586,0,32586,3,32589,0
6542,32590,0,32590,3,32593,0
6543,32596,0,32596,3,32599,0
6544,32599,0,32599,3,32602,0
6545,32602,0,32602,3,32605,0
6546,32608,0,32608,3,32611,0
6547,32611,0,32611,3,32614,0
6547,32614,0,32614,3,32617,0
6547,32617,0,32617,3,32620,0
6548,32619,1,32620,3,32623,1
6547,32620,3,32623,3,32626,1
6549,32621,5,32626,3,32629,2
6549,32629,0,32629,3,32632,0
6550,32629,3,32632,3,32635,1
6549,32632,3,32635,3,32638,1
6551,32639,0,32639,3,32642,0
6552,32643,0,32643,3,32646,0
6552,32646,0,32646,3,32649,0
6552,32649,0,32649,3,32652,0
6553,32651,1,32652,3,32655,1
6552,32652,3,32655,3,32658,1
6554,32658,0,32658,3,32661,0
6555,32659,2,32661,3,32664,1
6556,32663,1,32664,3,32667,1
6557,32670,0,32670,3,32673,0
6558,32674,0,32674,3,32677,0
6559,32677,0,32677,3,32680,0
6560,32684,0,32684,3,32687,0
6561,32689,0,32689,3,32692,0
6562,32693,0,32693,3,32696,0
6563,32696,0,32696,3,32699,0
6564,32706,0,32706,3,32709,0
6564,32709,0,32709,3,32712,0
6565,32709,3,32712,3,32715,1
6566,32711,4,32715,3,32718,2
6567,32714,4,32718,3,32721,2
6568,32719,2,32721,3,32724,1
6569,32721,3,32724,3,32727,1
6570,32725,2,32727,3,32730,1
6571,32728,2,32730,3,32733,1
6570,32730,3,32733,3,32736,1
6572,32732,4,32736,3,32739,2
6570,32733,6,32739,3,32742,2
6573,32734,8,32742,3,32745,3
6570,32736,9,32745,3,32748,3
6574,32740,8,32748,3,32751,3
6575,32744,7,32751,3,32754,3
6572,32745,9,32754,3,32757,3
6576,32745,12,32757,3,32760,4
6572,32748,12,32760,3,32763,4
6577,32757,6,32763,3,32766,2
6578,32762,4,32766,3,32769,2
6579,32765,4,32769,3,32772,2
6580,32771,1,32772,3,32775,1
6580,32775,0,32775,3,32778,0
6581,32779,0,32779,3,32782,0
6582,32781,1,32782,3,32785,1
6583,32782,3,32785,3,32788,1
6583,32788,0,32788,3,32791,0
6584,32789,2,32791,3,32794,1
6583,32791,3,32794,3,32797,1
6585,32793,4,32797,3,32800,2
6583,32794,6,32800,3,32803,2
6583,32797,6,32803,3,32806,2
6586,32798,8,32806,3,32809,3
6583,32800,9,32809,3,32812,3
6587,32806,6,32812,3,32815,2
6588,32812,3,32815,3,32818,1
6589,32817,1,32818,3,32821,1
6589,32821,0,32821,3,32824,0
6590,32824,0,32824,3,32827,0
6591,32824,3,32827,3,32830,1
6592,32825,5,32830,3,32833,2
6590,32827,6,32833,3,32836,2
6593,32830,6,32836,3,32839,2
6591,32833,6,32839,3,32842,2
6591,32836,6,32842,3,32845,2
6594,32839,6,32845,3,32848,2
6592,32842,6,32848,3,32851,2
6595,32842,9,32851,3,32854,3
6592,32845,9,32854,3,32857,3
6596,32845,12,32857,3,32860,4
6597,32848,12,32860,3,32863,4
6598,32856,7,32863,3,32866,3
6599,32862,4,32866,3,32869,2
6600,32866,3,32869,3,32872,1
6601,32873,0,32873,3,32876,0
6602,32877,0,32877,3,32880,0
6603,32882,0,32882,3,32885,0
6603,32885,0,32885,3,32888,0
6603,32888,0,32888,3,32891,0
6603,32891,0,32891,3,32894,0
6604,32893,1,32894,3,32897,1
6605,32902,0,32902,3,32905,0
6606,32909,0,32909,3,32912,0
6607,32914,0,32914,3,32917,0
6608,32917,0,32917,3,32920,0
6609,32923,0,32923,3,32926,0
6609,32926,0,32926,3,32929,0
6610,32928,1,32929,3,32932,1
6611,32934,0,32934,3,32937,0
6611,32937,0,32937,3,32940,0
6612,32939,1,32940,3,32943,1
6612,32943,0,32943,3,32946,0
6613,32943,3,32946,3,32949,1
6612,32946,3,32949,3,32952,1
6614,32949,3,32952,3,32955,1
6614,32955,0,32955,3,32958,0
6615,32957,1,32958,3,32961,1
6615,32961,0,32961,3,32964,0
6615,32964,0,32964,3,32967,0
6616,32964,3,32967,3,32970,1
6617,32971,0,32971,3,32974,0
6618,32973,1,32974,3,32977,1
6619,32981,0,32981,3,32984,0
6620,32984,0,32984,3,32987,0
6620,32987,0,32987,3,32990,0
6621,32988,2,32990,3,32993,1
6620,32990,3,32993,3,32996,1
6620,32993,3,32996,3,32999,1
6622,32995,4,32999,3,33002,2
6620,32996,6,33002,3,33005,2
6623,32999,6,33005,3,33008,2
6624,33003,5,33008,3,33011,2
6622,33005,6,33011,3,33014,2
6625,33013,1,33014,3,33017,1
6626,33015,2,33017,3,33020,1
6627,33024,0,33024,3,33027,0
6628,33030,0,33030,3,33033,0
6629,33033,0,33033,3,33036,0
6630,33038,0,33038,3,33041,0
6631,33047,0,33047,3,33050,0
6632,33057,0,33057,3,33060,0
6633,33063,0,33063,3,33066,0
6634,33065,1,33066,3,33069,1
6633,33066,3,33069,3,33072,1
6635,33068,4,33072,3,33075,2
6636,33070,5,33075,3,33078,2
6634,33072,6,33078,3,33081,2
6637,33076,5,33081,3,33084,2
6635,33078,6,33084,3,33087,2
6638,33080,7,33087,3,33090,3
6639,33085,5,33090,3,33093,2
6640,33088,5,33093,3,33096,2
6641,33091,5,33096,3,33099,2
6642,33101,0,33101,3,33104,0
6643,33105,0,33105,3,33108,0
6644,33109,0,33109,3,33112,0
6645,33114,0,33114,3,33117,0
6646,33120,0,33120,3,33123,0
6647,33127,0,33127,3,33130,0
6648,33129,1,33130,3,33133,1
6648,33133,0,33133,3,33136,0
6649,33135,1,33136,3,33139,1
6648,33136,3,33139,3,33142,1
6650,33140,2,33142,3,33145,1
6651,33143,2,33145,3,33148,1
6650,33145,3,33148,3,33151,1
6652,33147,4,33151,3,33154,2
6652,33154,0,33154,3,33157,0
6653,33155,2,33157,3,33160,1
6654,33158,2,33160,3,33163,1
6655,33162,1,33163,3,33166,1
6656,33164,2,33166,3,33169,1
6657,33171,0,33171,3,33174,0
6658,33176,0,33176,3,33179,0
6659,33182,0,33182,3,33185,0
6660,33189,0,33189,3,33192,0
6661,33197,0,33197,3,33200,0
6661,33200,0,33200,3,33203,0
6662,33201,2,33203,3,33206,1
6663,33203,3,33206,3,33209,1
6664,33207,2,33209,3,33212,1
6663,33209,3,33212,3,33215,1
6665,33210,5,33215,3,33218,2
6666,33214,4,33218,3,33221,2
6665,33218,3,33221,3,33224,1
6665,33221,3,33224,3,33227,1
6667,33222,5,33227,3,33230,2
6668,33228,2,33230,3,33233,1
6669,33231,2,33233,3,33236,1
6670,33235,1,33236,3,33239,1
6670,33239,0,33239,3,33242,0
6671,33239,3,33242,3,33245,1
6670,33242,3,33245,3,33248,1
6672,33245,3,33248,3,33251,1
6672,33251,0,33251,3,33254,0
6673,33252,2,33254,3,33257,1
6674,33257,0,33257,3,33260,0
6674,33260,0,33260,3,33263,0
6675,33267,0,33267,3,33270,0
6676,33277,0,33277,3,33280,0
6676,33280,0,33280,3,33283,0
6677,33282,1,33283,3,33286,1
6678,33289,0,33289,3,33292,0
6679,33297,0,33297,3,33300,0
6679,33300,0,33300,3,33303,0
6680,33300,3,33303,3,33306,1
6680,33306,0,33306,3,33309,0
6681,33308,1,33309,3,33312,1
6682,33319,0,33319,3,33322,0
6682,33322,0,33322,3,33325,0
6683,33324,1,33325,3,33328,1
6682,33325,3,33328,3,33331,1
6684,33327,4,33331,3,33334,2
6685,33332,2,33334,3,33337,1
6686,33332,5,33337,3,33340,2
6685,33337,3,33340,3,33343,1
6687,33337,6,33343,3,33346,2
6685,33340,6,33346,3,33349,2
6688,33343,6,33349,3,33352,2
6689,33348,4,33352,3,33355,2
6687,33349,6,33355,3,33358,2
6690,33354,4,33358,3,33361,2
6691,33360,1,33361,3,33364,1
6692,33366,0,33366,3,33369,0
6693,33373,0,33373,3,33376,0
6694,33378,0,33378,3,33381,0
6694,33381,0,33381,3,33384,0
6695,33383,1,33384,3,33387,1
6696,33386,1,33387,3,33390,1
6697,33391,0,33391,3,33394,0
6698,33396,0,33396,3,33399,0
6699,33401,0,33401,3,33404,0
6700,33406,0,33406,3,33409,0
6701,33411,0,33411,3,33414,0
6701,33414,0,33414,3,33417,0
6702,33414,3,33417,3,33420,1
6703,33418,2,33420,3,33423,1
6702,33420,3,33423,3,33426,1
6704,33421,5,33426,3,33429,2
6705,33425,4,33429,3,33432,2
6706,33429,3,33432,3,33435,1
6705,33432,3,33435,3,33438,1
6707,33433,5,33438,3,33441,2
6708,33434,7,33441,3,33444,3
6709,33440,4,33444,3,33447,2
6710,33442,5,33447,3,33450,2
6711,33446,4,33450,3,33453,2
6709,33447,6,33453,3,33456,2
6712,33451,5,33456,3,33459,2
6713,33453,6,33459,3,33462,2
6711,33456,6,33462,3,33465,2
6711,33459,6,33465,3,33468,2
6714,33460,8,33468,3,33471,3
6715,33466,5,33471,3,33474,2
6716,33470,4,33474,3,33477,2
6717,33477,0,33477,3,33480,0
6718,33484,0,33484,3,33487,0
6718,33487,0,33487,3,33490,0
6719,33487,3,33490,3,33493,1
6718,33490,3,33493,3,33496,1
6720,33491,5,33496,3,33499,2
6721,33495,4,33499,3,33502,2
6722,33496,6,33502,3,33505,2
6723,33501,4,33505,3,33508,2
6724,33503,5,33508,3,33511,2
6722,33505,6,33511,3,33514,2
6725,33506,8,33514,3,33517,3
6726,33514,3,33517,3,33520,1
6725,33517,3,33520,3,33523,1
6727,33519,4,33523,3,33526,2
6725,33520,6,33526,3,33529,2
6728,33523,6,33529,3,33532,2
6729,33525,7,33532,3,33535,3
6728,33532,3,33535,3,33538,1
6730,33534,4,33538,3,33541,2
6731,33540,1,33541,3,33544,1
6730,33541,3,33544,3,33547,1
6731,33547,0,33547,3,33550,0
6732,33547,3,33550,3,33553,1
6733,33549,4,33553,3,33556,2
6734,33552,4,33556,3,33559,2
6735,33554,5,33559,3,33562,2
6736,33559,3,33562,3,33565,1
6735,33562,3,33565,3,33568,1
6735,33565,3,33568,3,33571,1
6737,33565,6,33571,3,33574,2
6736,33571,3,33574,3,33577,1
6738,33571,6,33577,3,33580,2
6739,33574,6,33580,3,33583,2
6740,33577,6,33583,3,33586,2
6741,33585,1,33586,3,33589,1
6740,33586,3,33589,3,33592,1
6742,33586,6,33592,3,33595,2
6743,33590,5,33595,3,33598,2
6744,33599,0,33599,3,33602,0
6745,33606,0,33606,3,33609,0
6746,33613,0,33613,3,33616,0
6747,33616,0,33616,3,33619,0
6747,33619,0,33619,3,33622,0
6748,33624,0,33624,3,33627,0
6748,33627,0,33627,3,33630,0
6749,33627,3,33630,3,33633,1
6748,33630,3,33633,3,33636,1
6749,33636,0,33636,3,33639,0
6750,33638,1,33639,3,33642,1
6750,33642,0,33642,3,33645,0
6751,33645,0,33645,3,33648,0
6752,33649,0,33649,3,33652,0
6753,33651,1,33652,3,33655,1
6753,33655,0,33655,3,33658,0
6754,33659,0,33659,3,33662,0
6755,33665,0,33665,3,33668,0
6756,33672,0,33672,3,33675,0
6757,33679,0,33679,3,33682,0
6758,33685,0,33685,3,33688,0
6759,33690,0,33690,3,33693,0
6759,33693,0,33693,3,33696,0
6760,33694,2,33696,3,33699,1
6759,33696,3,33699,3,33702,1
6759,33699,3,33702,3,33705,1
6761,33700,5,33705,3,33708,2
6762,33704,4,33708,3,33711,2
6763,33709,2,33711,3,33714,1
6764,33711,3,33714,3,33717,1
6764,33717,0,33717,3,33720,0
6765,33718,2,33720,3,33723,1
6764,33720,3,33723,3,33726,1
6764,33723,3,33726,3,33729,1
6766,33725,4,33729,3,33732,2
6767,33730,2,33732,3,33735,1
6768,33734,1,33735,3,33738,1
6769,33738,0,33738,3,33741,0
6770,33742,0,33742,3,33745,0
6771,33747,0,33747,3,33750,0
6771,33750,0,33750,3,33753,0
6772,33751,2,33753,3,33756,1
6773,33753,3,33756,3,33759,1
6774,33756,3,33759,3,33762,1
6773,33759,3,33762,3,33765,1
6775,33761,4,33765,3,33768,2
6773,33762,6,33768,3,33771,2
6776,33765,6,33771,3,33774,2
6775,33771,3,33774,3,33777,1
6777,33773,4,33777,3,33780,2
6778,33777,3,33780,3,33783,1
6778,33783,0,33783,3,33786,0
6779,33784,2,33786,3,33789,1
6780,33788,1,33789,3,33792,1
6779,33789,3,33792,3,33795,1
6781,33790,5,33795,3,33798,2
6779,33792,6,33798,3,33801,2
6782,33795,6,33801,3,33804,2
6780,33798,6,33804,3,33807,2
6783,33802,5,33807,3,33810,2
6784,33806,4,33810,3,33813,2
6785,33812,1,33813,3,33816,1
6786,33822,0,33822,3,33825,0
6787,33828,0,33828,3,33831,0
6787,33831,0,33831,3,33834,0
6788,33832,2,33834,3,33837,1
6789,33833,4,33837,3,33840,2
6790,33838,2,33840,3,33843,1
6789,33840,3,33843,3,33846,1
6791,33843,3,33846,3,33849,1
6791,33849,0,33849,3,33852,0
6792,33849,3,33852,3,33855,1
6793,33856,0,33856,3,33859,0
6794,33861,0,33861,3,33864,0
6794,33864,0,33864,3,33867,0
6795,33869,0,33869,3,33872,0
6795,33872,0,33872,3,33875,0
6795,33875,0,33875,3,33878,0
6796,33875,3,33878,3,33881,1
6796,33881,0,33881,3,33884,0
6797,33881,3,33884,3,33887,1
6797,33887,0,33887,3,33890,0
6798,33887,3,33890,3,33893,1
6799,33896,0,33896,3,33899,0
6800,33899,0,33899,3,33902,0
6801,33903,0,33903,3,33906,0
6802,33906,0,33906,3,33909,0
6803,33908,1,33909,3,33912,1
6804,33911,1,33912,3,33915,1
6805,33914,1,33915,3,33918,1
6806,33923,0,33923,3,33926,0
6807,33927,0,33927,3,33930,0
6808,33933,0,33933,3,33936,0
6809,33937,0,33937,3,33940,0
6810,33945,0,33945,3,33948,0
6811,33949,0,33949,3,33952,0
6812,33953,0,33953,3,33956,0
6813,33958,0,33958,3,33961,0
6813,33961,0,33961,3,33964,0
6814,33964,0,33964,3,33967,0
6814,33967,0,33967,3,33970,0
6815,33968,2,33970,3,33973,1
6814,33970,3,33973,3,33976,1
6814,33973,3,33976,3,33979,1
6815,33979,0,33979,3,33982,0
6816,33979,3,33982,3,33985,1
6817,33984,1,33985,3,33988,1
6818,33991,0,33991,3,33994,0
6818,33994,0,33994,3,33997,0
6819,33996,1,33997,3,34000,1
6818,33997,3,34000,3,34003,1
6820,33998,5,34003,3,34006,2
6821,34002,4,34006,3,34009,2
6822,34009,0,34009,3,34012,0
6823,34014,0,34014,3,34017,0
6824,34017,0,34017,3,34020,0
6825,34020,0,34020,3,34023,0
6826,34022,1,34023,3,34026,1
6827,34024,2,34026,3,34029,1
6828,34029,0,34029,3,34032,0
6829,34033,0,34033,3,34036,0
6829,34036,0,34036,3,34039,0
6830,34041,0,34041,3,34044,0
6830,34044,0,34044,3,34047,0
6831,34046,1,34047,3,34050,1
6830,34047,3,34050,3,34053,1
6832,34051,2,34053,3,34056,1
6833,34051,5,34056,3,34059,2
6834,34057,2,34059,3,34062,1
6835,34065,0,34065,3,34068,0
6836,34067,1,34068,3,34071,1
6837,34075,0,34075,3,34078,0
6838,34081,0,34081,3,34084,0
6839,34085,0,34085,3,34088,0
6839,34088,0,34088,3,34091,0
6840,34089,2,34091,3,34094,1
6839,34091,3,34094,3,34097,1
6841,34092,5,34097,3,34100,2
6842,34101,0,34101,3,34104,0
6843,34106,0,34106,3,34109,0
6843,34109,0,34109,3,34112,0
6844,34109,3,34112,3,34115,1
6843,34112,3,34115,3,34118,1
6845,34115,3,34118,3,34121,1
6844,34118,3,34121,3,34124,1
6846,34121,3,34124,3,34127,1
6847,34124,3,34127,3,34130,1
6848,34125,5,34130,3,34133,2
6849,34130,3,34133,3,34136,1
6850,34136,0,34136,3,34139,0
6851,34137,2,34139,3,34142,1
6852,34143,0,34143,3,34146,0
6853,34146,0,34146,3,34149,0
6853,34149,0,34149,3,34152,0
6854,34150,2,34152,3,34155,1
6853,34152,3,34155,3,34158,1
6853,34155,3,34158,3,34161,1
6855,34157,4,34161,3,34164,2
6853,34158,6,34164,3,34167,2
6856,34162,5,34167,3,34170,2
6854,34164,6,34170,3,34173,2
6857,34165,8,34173,3,34176,3
6858,34169,7,34176,3,34179,3
6859,34175,4,34179,3,34182,2
6860,34181,1,34182,3,34185,1
6859,34182,3,34185,3,34188,1
6859,34185,3,34188,3,34191,1
6859,34188,3,34191,3,34194,1
6861,34190,4,34194,3,34197,2
6860,34194,3,34197,3,34200,1
6862,34194,6,34200,3,34203,2
6863,34196,7,34203,3,34206,3
6864,34201,5,34206,3,34209,2
6865,34207,2,34209,3,34212,1
6864,34209,3,34212,3,34215,1
6866,34212,3,34215,3,34218,1
6867,34213,5,34218,3,34221,2
6868,34219,2,34221,3,34224,1
6869,34222,2,34224,3,34227,1
6869,34227,0,34227,3,34230,0
6870,34229,1,34230,3,34233,1
6871,34231,2,34233,3,34236,1
6872,34240,0,34240,3,34243,0
6872,34243,0,34243,3,34246,0
6873,34244,2,34246,3,34249,1
6874,34249,0,34249,3,34252,0
6875,34255,0,34255,3,34258,0
6876,34260,0,34260,3,34263,0
6877,34262,1,34263,3,34266,1
6878,34265,1,34266,3,34269,1
6879,34270,0,34270,3,34273,0
6879,34273,0,34273,3,34276,0
6879,34276,0,34276,3,34279,0
6880,34277,2,34279,3,34282,1
6881,34279,3,34282,3,34285,1
6881,34285,0,34285,3,34288,0
6882,34287,1,34288,3,34291,1
6882,34291,0,34291,3,34294,0
6883,34291,3,34294,3,34297,1
6884,34295,2,34297,3,34300,1
6884,34300,0,34300,3,34303,0
6885,34302,1,34303,3,34306,1
6886,34306,0,34306,3,34309,0
6887,34309,0,34309,3,34312,0
6888,34315,0,34315,3,34318,0
6888,34318,0,34318,3,34321,0
6889,34320,1,34321,3,34324,1
6890,34327,0,34327,3,34330,0
6891,34331,0,34331,3,34334,0
6891,34334,0,34334,3,34337,0
6892,34335,2,34337,3,34340,1
6891,34337,3,34340,3,34343,1
6893,34339,4,34343,3,34346,2
6894,34345,1,34346,3,34349,1
6895,34353,0,34353,3,34356,0
6895,34356,0,34356,3,34359,0
6896,34357,2,34359,3,34362,1
6895,34359,3,34362,3,34365,1
6897,34359,6,34365,3,34368,2
6898,34364,4,34368,3,34371,2
6899,34365,6,34371,3,34374,2
6900,34369,5,34374,3,34377,2
6901,34373,4,34377,3,34380,2
6902,34375,5,34380,3,34383,2
6903,34375,8,34383,3,34386,3
6900,34377,9,34386,3,34389,3
6900,34380,9,34389,3,34392,3
6904,34380,12,34392,3,34395,4
6905,34383,12,34395,3,34398,4
6906,34388,10,34398,3,34401,4
6903,34392,9,34401,3,34404,3
6907,34393,11,34404,3,34407,4
6908,34399,8,34407,3,34410,3
6909,34406,4,34410,3,34413,2
6907,34407,6,34413,3,34416,2
6910,34411,5,34416,3,34419,2
6911,34415,4,34419,3,34422,2
6912,34422,0,34422,3,34425,0
6912,34425,0,34425,3,34428,0
6913,34429,0,34429,3,34432,0
6914,34439,0,34439,3,34442,0
6914,34442,0,34442,3,34445,0
6914,34445,0,34445,3,34448,0
6915,34447,1,34448,3,34451,1
6914,34448,3,34451,3,34454,1
6916,34453,1,34454,3,34457,1
6916,34457,0,34457,3,34460,0
6917,34458,2,34460,3,34463,1
6916,34460,3,34463,3,34466,1
6918,34465,1,34466,3,34469,1
6919,34478,0,34478,3,34481,0
6920,34482,0,34482,3,34485,0
6921,34485,0,34485,3,34488,0
6922,34491,0,34491,3,34494,0
6923,34493,1,34494,3,34497,1
6924,34495,2,34497,3,34500,1
6923,34497,3,34500,3,34503,1
6925,34498,5,34503,3,34506,2
6926,34503,3,34506,3,34509,1
6927,34509,0,34509,3,34512,0
6928,34513,0,34513,3,34516,0
6929,34522,0,34522,3,34525,0
6930,34527,0,34527,3,34530,0
6931,34531,0,34531,3,34534,0
6932,34536,0,34536,3,34539,0
6932,34539,0,34539,3,34542,0
6933,34541,1,34542,3,34545,1
6934,34546,0,34546,3,34549,0
6934,34549,0,34549,3,34552,0
6935,34553,0,34553,3,34556,0
6936,34557,0,34557,3,34560,0
6937,34560,0,34560,3,34563,0
6938,34565,0,34565,3,34568,0
6939,34567,1,34568,3,34571,1
6940,34570,1,34571,3,34574,1
6941,34573,1,34574,3,34577,1
6942,34580,0,34580,3,34583,0
6942,34583,0,34583,3,34586,0
6943,34584,2,34586,3,34589,1
6943,34589,0,34589,3,34592,0
6944,34590,2,34592,3,34595,1
6945,34594,1,34595,3,34598,1
6945,34598,0,34598,3,34601,0
6946,34600,1,34601,3,34604,1
6947,34602,2,34604,3,34607,1
6948,34604,3,34607,3,34610,1
6949,34609,1,34610,3,34613,1
6950,34615,0,34615,3,34618,0
6950,34618,0,34618,3,34621,0
6951,34620,1,34621,3,34624,1
6951,34624,0,34624,3,34627,0
6952,34625,2,34627,3,34630,1
6951,34627,3,34630,3,34633,1
6953,34630,3,34633,3,34636,1
6954,34635,1,34636,3,34639,1
6953,34636,3,34639,3,34642,1
6954,34642,0,34642,3,34645,0
6955,34643,2,34645,3,34648,1
6954,34645,3,34648,3,34651,1
6956,34645,6,34651,3,34654,2
6957,34654,0,34654,3,34657,0
6958,34661,0,34661,3,34664,0
6959,34664,0,34664,3,34667,0
6960,34667,0,34667,3,34670,0
6961,34672,0,34672,3,34675,0
6962,34679,0,34679,3,34682,0
6963,34686,0,34686,3,34689,0
6964,34693,0,34693,3,34696,0
6965,34695,1,34696,3,34699,1
6966,34701,0,34701,3,34704,0
6967,34707,0,34707,3,34710,0
6967,34710,0,34710,3,34713,0
6968,34711,2,34713,3,34716,1
6969,34714,2,34716,3,34719,1
6970,34715,4,34719,3,34722,2
6969,34719,3,34722,3,34725,1
6971,34719,6,34725,3,34728,2
6972,34724,4,34728,3,34731,2
6973,34728,3,34731,3,34734,1
6974,34737,0,34737,3,34740,0
6975,34743,0,34743,3,34746,0
6976,34746,0,34746,3,34749,0
6977,34748,1,34749,3,34752,1
6977,34752,0,34752,3,34755,0
6978,34752,3,34755,3,34758,1
6977,34755,3,34758,3,34761,1
6979,34760,1,34761,3,34764,1
6980,34760,4,34764,3,34767,2
6978,34761,6,34767,3,34770,2
6981,34767,3,34770,3,34773,1
6982,34769,4,34773,3,34776,2
6983,34773,3,34776,3,34779,1
6984,34777,2,34779,3,34782,1
6985,34779,3,34782,3,34785,1
6984,34782,3,34785,3,34788,1
6986,34782,6,34788,3,34791,2
6987,34786,5,34791,3,34794,2
6988,34786,8,34794,3,34797,3
6989,34791,6,34797,3,34800,2
6990,34795,5,34800,3,34803,2
6991,34801,2,34803,3,34806,1
6992,34807,0,34807,3,34810,0
6993,34810,0,34810,3,34813,0
6994,34816,0,34816,3,34819,0
6995,34824,0,34824,3,34827,0
6995,34827,0,34827,3,34830,0
6996,34828,2,34830,3,34833,1
6996,34833,0,34833,3,34836,0
6997,34834,2,34836,3,34839,1
6997,34839,0,34839,3,34842,0
6998,34839,3,34842,3,34845,1
6999,34842,3,34845,3,34848,1
7000,34848,0,34848,3,34851,0
7001,34857,0,34857,3,34860,0
7001,34860,0,34860,3,34863,0
7002,34862,1,34863,3,34866,1
7001,34863,3,34866,3,34869,1
7003,34865,4,34869,3,34872,2
7001,34866,6,34872,3,34875,2
7004,34867,8,34875,3,34878,3
7001,34869,9,34878,3,34881,3
7005,34873,8,34881,3,34884,3
7006,34875,9,34884,3,34887,3
7007,34879,8,34887,3,34890,3
7004,34881,9,34890,3,34893,3
7008,34883,10,34893,3,34896,4
7009,34889,7,34896,3,34899,3
7010,34891,8,34899,3,34902,3
7011,34895,7,34902,3,34905,3
7012,34900,5,34905,3,34908,2
7013,34901,7,34908,3,34911,3
7014,34901,10,34911,3,34914,4
7012,34908,6,34914,3,34917,2
7015,34908,9,34917,3,34920,3
7012,34911,9,34920,3,34923,3
7012,34914,9,34923,3,34926,3
7016,34914,12,34926,3,34929,4
7013,34920,9,34929,3,34932,3
7017,34920,12,34932,3,34935,4
7013,34923,12,34935,3,34938,4
7018,34923,15,34938,3,34941,5
7014,34929,12,34941,3,34944,4
7019,34930,14,34944,3,34947,5
7014,34932,15,34947,3,34950,5
7014,34935,15,34950,3,34953,5
7020,34937,16,34953,3,34956,6
7014,34938,18,34956,3,34959,6
7021,34944,15,34959,3,34962,5
7022,34949,13,34962,3,34965,5
7023,34954,11,34965,3,34968,4
7024,34961,7,34968,3,34971,3
7025,34967,4,34971,3,34974,2
7024,34971,3,34974,3,34977,1
7026,34974,3,34977,3,34980,1
7027,34983,0,34983,3,34986,0
7028,34990,0,34990,3,34993,0
7029,34995,0,34995,3,34998,0
7029,34998,0,34998,3,35001,0
7030,35000,1,35001,3,35004,1
7031,35006,0,35006,3,35009,0
7032,35010,0,35010,3,35013,0
7032,35013,0,35013,3,35016,0
7033,35015,1,35016,3,35019,1
7034,35018,1,35019,3,35022,1
7035,35025,0,35025,3,35028,0
7035,35028,0,35028,3,35031,0
7036,35028,3,35031,3,35034,1
7037,35032,2,35034,3,35037,1
7036,35034,3,35037,3,35040,1
7038,35037,3,35040,3,35043,1
7039,35045,0,35045,3,35048,0
7040,35055,0,35055,3,35058,0
7041,35064,0,35064,3,35067,0
7042,35068,0,35068,3,35071,0
7042,35071,0,35071,3,35074,0
7043,35071,3,35074,3,35077,1
7044,35076,1,35077,3,35080,1
7044,35080,0,35080,3,35083,0
7045,35082,1,35083,3,35086,1
7044,35083,3,35086,3,35089,1
7046,35085,4,35089,3,35092,2
7044,35086,6,35092,3,35095,2
7044,35089,6,35095,3,35098,2
7047,35091,7,35098,3,35101,3
7045,35095,6,35101,3,35104,2
7048,35101,3,35104,3,35107,1
7047,35104,3,35107,3,35110,1
7049,35106,4,35110,3,35113,2
7048,35110,3,35113,3,35116,1
7050,35110,6,35116,3,35119,2
7051,35117,2,35119,3,35122,1
7051,35122,0,35122,3,35125,0
7052,35127,0,35127,3,35130,0
7053,35136,0,35136,3,35139,0
7054,35140,0,35140,3,35143,0
7054,35143,0,35143,3,35146,0
7055,35144,2,35146,3,35149,1
7055,35149,0,35149,3,35152,0
7056,35149,3,35152,3,35155,1
7055,35152,3,35155,3,35158,1
7057,35154,4,35158,3,35161,2
7055,35155,6,35161,3,35164,2
7058,35156,8,35164,3,35167,3
7059,35159,8,35167,3,35170,3
7056,35161,9,35170,3,35173,3
7056,35164,9,35173,3,35176,3
7060,35165,11,35176,3,35179,4
7061,35168,11,35179,3,35182,4
7057,35170,12,35182,3,35185,4
7062,35171,14,35185,3,35188,5
7057,35173,15,35188,3,35191,5
7063,35174,17,35191,3,35194,6
7057,35176,18,35194,3,35197,6
7064,35177,20,35197,3,35200,7
7065,35182,18,35200,3,35203,6
7066,35183,20,35203,3,35206,7
7067,35187,19,35206,3,35209,7
7068,35189,20,35209,3,35212,7
7069,35197,15,35212,3,35215,5
7070,35202,13,35215,3,35218,5
7065,35203,15,35218,3,35221,5
7065,35206,15,35221,3,35224,5
7071,35207,17,35224,3,35227,6
7072,35216,11,35227,3,35230,4
7073,35219,11,35230,3,35233,4
7074,35222,11,35233,3,35236,4
7070,35224,12,35236,3,35239,4
7075,35226,13,35239,3,35242,5
7071,35230,12,35242,3,35245,4
7076,35232,13,35245,3,35248,5
7072,35236,12,35248,3,35251,4
7077,35236,15,35251,3,35254,5
7078,35242,12,35254,3,35257,4
7076,35251,6,35257,3,35260,2
7079,35252,8,35260,3,35263,3
7080,35260,3,35263,3,35266,1
7079,35263,3,35266,3,35269,1
7081,35268,1,35269,3,35272,1
7080,35269,3,35272,3,35275,1
7081,35275,0,35275,3,35278,0
7082,35277,1,35278,3,35281,1
7082,35281,0,35281,3,35284,0
7083,35283,1,35284,3,35287,1
7084,35288,0,35288,3,35291,0
7084,35291,0,35291,3,35294,0
7085,35293,1,35294,3,35297,1
7086,35300,0,35300,3,35303,0
7086,35303,0,35303,3,35306,0
7087,35303,3,35306,3,35309,1
7088,35309,0,35309,3,35312,0
7088,35312,0,35312,3,35315,0
7089,35317,0,35317,3,35320,0
7090,35320,0,35320,3,35323,0
7090,35323,0,35323,3,35326,0
7091,35326,0,35326,3,35329,0
7092,35332,0,35332,3,35335,0
7093,35335,0,35335,3,35338,0
7093,35338,0,35338,3,35341,0
7094,35341,0,35341,3,35344,0
7095,35344,0,35344,3,35347,0
7096,35346,1,35347,3,35350,1
7095,35347,3,35350,3,35353,1
7095,35350,3,35353,3,35356,1
7095,35353,3,35356,3,35359,1
7097,35354,5,35359,3,35362,2
7098,35359,3,35362,3,35365,1
7099,35364,1,35365,3,35368,1
7100,35375,0,35375,3,35378,0
7101,35377,1,35378,3,35381,1
7101,35381,0,35381,3,35384,0
7102,35382,2,35384,3,35387,1
7103,35389,0,35389,3,35392,0
7104,35397,0,35397,3,35400,0
7105,35398,2,35400,3,35403,1
7106,35407,0,35407,3,35410,0
7106,35410,0,35410,3,35413,0
7107,35412,1,35413,3,35416,1
7107,35416,0,35416,3,35419,0
7108,35417,2,35419,3,35422,1
7109,35421,1,35422,3,35425,1
7108,35422,3,35425,3,35428,1
7108,35425,3,35428,3,35431,1
7110,35425,6,35431,3,35434,2
7111,35425,9,35434,3,35437,3
7112,35429,8,35437,3,35440,3
7109,35431,9,35440,3,35443,3
7113,35435,8,35443,3,35446,3
7114,35440,6,35446,3,35449,2
7115,35443,6,35449,3,35452,2
7116,35448,4,35452,3,35455,2
7115,35452,3,35455,3,35458,1
7117,35453,5,35458,3,35461,2
7118,35461,0,35461,3,35464,0
7119,35465,0,35465,3,35468,0
7120,35468,0,35468,3,35471,0
7121,35472,0,35472,3,35475,0
7122,35475,0,35475,3,35478,0
7122,35478,0,35478,3,35481,0
7122,35481,0,35481,3,35484,0
7123,35483,1,35484,3,35487,1
7123,35487,0,35487,3,35490,0
7124,35487,3,35490,3,35493,1
7125,35491,2,35493,3,35496,1
7126,35494,2,35496,3,35499,1
7127,35499,0,35499,3,35502,0
7128,35504,0,35504,3,35507,0
7128,35507,0,35507,3,35510,0
7129,35510,0,35510,3,35513,0
7130,35516,0,35516,3,35519,0
7131,35518,1,35519,3,35522,1
7130,35519,3,35522,3,35525,1
7130,35522,3,35525,3,35528,1
7132,35523,5,35528,3,35531,2
7133,35527,4,35531,3,35534,2
7131,35528,6,35534,3,35537,2
7134,35530,7,35537,3,35540,3
7135,35533,7,35540,3,35543,3
7136,35538,5,35543,3,35546,2
7134,35540,6,35546,3,35549,2
7134,35543,6,35549,3,35552,2
7137,35543,9,35552,3,35555,3
7138,35547,8,35555,3,35558,3
7139,35552,6,35558,3,35561,2
7140,35557,4,35561,3,35564,2
7138,35558,6,35564,3,35567,2
7138,35561,6,35567,3,35570,2
7141,35567,3,35570,3,35573,1
7140,35570,3,35573,3,35576,1
7140,35573,3,35576,3,35579,1
7142,35573,6,35579,3,35582,2
7143,35579,3,35582,3,35585,1
7144,35580,5,35585,3,35588,2
7143,35585,3,35588,3,35591,1
7145,35585,6,35591,3,35594,2
7144,35591,3,35594,3,35597,1
7146,35591,6,35597,3,35600,2
7147,35597,3,35600,3,35603,1
7148,35604,0,35604,3,35607,0
7148,35607,0,35607,3,35610,0
7149,35608,2,35610,3,35613,1
7149,35613,0,35613,3,35616,0
7150,35613,3,35616,3,35619,1
7151,35622,0,35622,3,35625,0
7152,35627,0,35627,3,35630,0
7152,35630,0,35630,3,35633,0
7153,35635,0,35635,3,35638,0
7153,35638,0,35638,3,35641,0
7153,35641,0,35641,3,35644,0
7154,35643,1,35644,3,35647,1
7155,35650,0,35650,3,35653,0
7156,35655,0,35655,3,35658,0
7157,35656,2,35658,3,35661,1
7158,35657,4,35661,3,35664,2
7159,35661,3,35664,3,35667,1
7160,35664,3,35667,3,35670,1
7159,35667,3,35670,3,35673,1
7161,35670,3,35673,3,35676,1
7162,35672,4,35676,3,35679,2
7163,35680,0,35680,3,35683,0
7163,35683,0,35683,3,35686,0
7164,35684,2,35686,3,35689,1
7165,35688,1,35689,3,35692,1
7166,35693,0,35693,3,35696,0
7167,35697,0,35697,3,35700,0
7168,35703,0,35703,3,35706,0
7168,35706,0,35706,3,35709,0
7169,35706,3,35709,3,35712,1
7170,35707,5,35712,3,35715,2
7168,35709,6,35715,3,35718,2
7171,35711,7,35718,3,35721,3
7172,35714,7,35721,3,35724,3
7170,35718,6,35724,3,35727,2
7173,35720,7,35727,3,35730,3
7174,35726,4,35730,3,35733,2
7175,35734,0,35734,3,35737,0
7176,35739,0,35739,3,35742,0
7177,35745,0,35745,3,35748,0
7177,35748,0,35748,3,35751,0
7178,35754,0,35754,3,35757,0
7179,35759,0,35759,3,35762,0
7180,35762,0,35762,3,35765,0
7181,35766,0,35766,3,35769,0
7182,35773,0,35773,3,35776,0
7183,35775,1,35776,3,35779,1
7183,35779,0,35779,3,35782,0
7184,35781,1,35782,3,35785,1
7184,35785,0,35785,3,35788,0
7185,35787,1,35788,3,35791,1
7184,35788,3,35791,3,35794,1
7186,35791,3,35794,3,35797,1
7187,35798,0,35798,3,35801,0
7188,35803,0,35803,3,35806,0
7189,35813,0,35813,3,35816,0
7189,35816,0,35816,3,35819,0
7190,35822,0,35822,3,35825,0
7190,35825,0,35825,3,35828,0
7190,35828,0,35828,3,35831,0
7191,35828,3,35831,3,35834,1
7190,35831,3,35834,3,35837,1
7192,35832,5,35837,3,35840,2
7193,35838,2,35840,3,35843,1
7192,35840,3,35843,3,35846,1
7194,35843,3,35846,3,35849,1
7194,35849,0,35849,3,35852,0
7195,35849,3,35852,3,35855,1
7196,35852,3,35855,3,35858,1
7197,35857,1,35858,3,35861,1
7197,35861,0,35861,3,35864,0
7198,35863,1,35864,3,35867,1
7197,35864,3,35867,3,35870,1
7199,35866,4,35870,3,35873,2
7200,35868,5,35873,3,35876,2
7201,35871,5,35876,3,35879,2
7199,35873,6,35879,3,35882,2
7202,35876,6,35882,3,35885,2
7203,35879,6,35885,3,35888,2
7201,35882,6,35888,3,35891,2
7204,35886,5,35891,3,35894,2
7202,35888,6,35894,3,35897,2
7205,35888,9,35897,3,35900,3
7206,35894,6,35900,3,35903,2
7204,35897,6,35903,3,35906,2
7207,35898,8,35906,3,35909,3
7204,35900,9,35909,3,35912,3
7208,35902,10,35912,3,35915,4
7209,35906,9,35915,3,35918,3
7210,35914,4,35918,3,35921,2
7211,35918,3,35921,3,35924,1
7212,35926,0,35926,3,35929,0
7212,35929,0,35929,3,35932,0
7213,35929,3,35932,3,35935,1
7214,35933,2,35935,3,35938,1
7215,35942,0,35942,3,35945,0
7216,35948,0,35948,3,35951,0
7217,35957,0,35957,3,35960,0
7218,35965,0,35965,3,35968,0
7219,35973,0,35973,3,35976,0
7220,35982,0,35982,3,35985,0
7221,35984,1,35985,3,35988,1
7222,35988,0,35988,3,35991,0
7223,35993,0,35993,3,35996,0
7223,35996,0,35996,3,35999,0
7224,35996,3,35999,3,36002,1
7225,35997,5,36002,3,36005,2
7223,35999,6,36005,3,36008,2
7226,36004,4,36008,3,36011,2
7227,36004,7,36011,3,36014,3
7228,36007,7,36014,3,36017,3
7225,36008,9,36017,3,36020,3
7229,36012,8,36020,3,36023,3
7230,36017,6,36023,3,36026,2
7231,36021,5,36026,3,36029,2
7230,36026,3,36029,3,36032,1
7232,36028,4,36032,3,36035,2
7230,36029,6,36035,3,36038,2
7233,36031,7,36038,3,36041,3
7230,36032,9,36041,3,36044,3
7234,36034,10,36044,3,36047,4
7235,36037,10,36047,3,36050,4
7236,36038,12,36050,3,36053,4
7232,36041,12,36053,3,36056,4
7237,36046,10,36056,3,36059,4
7238,36052,7,36059,3,36062,3
7239,36053,9,36062,3,36065,3
7240,36060,5,36065,3,36068,2
7241,36062,6,36068,3,36071,2
7239,36065,6,36071,3,36074,2
7239,36068,6,36074,3,36077,2
7242,36069,8,36077,3,36080,3
7239,36071,9,36080,3,36083,3
7239,36074,9,36083,3,36086,3
7243,36077,9,36086,3,36089,3
7241,36083,6,36089,3,36092,2
7244,36084,8,36092,3,36095,3
7242,36089,6,36095,3,36098,2
7245,36091,7,36098,3,36101,3
7246,36098,3,36101,3,36104,1
7245,36101,3,36104,3,36107,1
7247,36104,3,36107,3,36110,1
7248,36112,0,36112,3,36115,0
7249,36116,0,36116,3,36119,0
7250,36123,0,36123,3,36126,0
7250,36126,0,36126,3,36129,0
7251,36127,2,36129,3,36132,1
7250,36129,3,36132,3,36135,1
7252,36130,5,36135,3,36138,2
7253,36137,1,36138,3,36141,1
7253,36141,0,36141,3,36144,0
7254,36144,0,36144,3,36147,0
7255,36150,0,36150,3,36153,0
7256,36154,0,36154,3,36157,0
7256,36157,0,36157,3,36160,0
7257,36157,3,36160,3,36163,1
7256,36160,3,36163,3,36166,1
7258,36160,6,36166,3,36169,2
7259,36163,6,36169,3,36172,2
7260,36167,5,36172,3,36175,2
7261,36173,2,36175,3,36178,1
7262,36177,1,36178,3,36181,1
7261,36178,3,36181,3,36184,1
7263,36185,0,36185,3,36188,0
7264,36188,0,36188,3,36191,0
7265,36191,0,36191,3,36194,0
7265,36194,0,36194,3,36197,0
7266,36198,0,36198,3,36201,0
7267,36201,0,36201,3,36204,0
7267,36204,0,36204,3,36207,0
7268,36208,0,36208,3,36211,0
7269,36210,1,36211,3,36214,1
7270,36214,0,36214,3,36217,0
7271,36219,0,36219,3,36222,0
7272,36221,1,36222,3,36225,1
7273,36223,2,36225,3,36228,1
7274,36227,1,36228,3,36231,1
7273,36228,3,36231,3,36234,1
7275,36233,1,36234,3,36237,1
7274,36234,3,36237,3,36240,1
7274,36237,3,36240,3,36243,1
7276,36242,1,36243,3,36246,1
7275,36243,3,36246,3,36249,1
7277,36245,4,36249,3,36252,2
7275,36246,6,36252,3,36255,2
7278,36251,4,36255,3,36258,2
7279,36257,1,36258,3,36261,1
7279,36261,0,36261,3,36264,0
7280,36263,1,36264,3,36267,1
7281,36269,0,36269,3,36272,0
7281,36272,0,36272,3,36275,0
7282,36273,2,36275,3,36278,1
7283,36274,4,36278,3,36281,2
7283,36281,0,36281,3,36284,0
7284,36281,3,36284,3,36287,1
7285,36287,0,36287,3,36290,0
7286,36293,0,36293,3,36296,0
7287,36298,0,36298,3,36301,0
7288,36300,1,36301,3,36304,1
7287,36301,3,36304,3,36307,1
7289,36311,0,36311,3,36314,0
7290,36315,0,36315,3,36318,0
7291,36323,0,36323,3,36326,0
7292,36333,0,36333,3,36336,0
7293,36335,1,36336,3,36339,1
7294,36347,0,36347,3,36350,0
7294,36350,0,36350,3,36353,0
7295,36352,1,36353,3,36356,1
7296,36355,1,36356,3,36359,1
7296,36359,0,36359,3,36362,0
7297,36361,1,36362,3,36365,1
7296,36362,3,36365,3,36368,1
7297,36368,0,36368,3,36371,0
7298,36370,1,36371,3,36374,1
7298,36374,0,36374,3,36377,0
7299,36374,3,36377,3,36380,1
7298,36377,3,36380,3,36383,1
7300,36378,5,36383,3,36386,2
7301,36382,4,36386,3,36389,2
7300,36386,3,36389,3,36392,1
7300,36389,3,36392,3,36395,1
7302,36389,6,36395,3,36398,2
7303,36398,0,36398,3,36401,0
7304,36403,0,36403,3,36406,0
7305,36409,0,36409,3,36412,0
7306,36413,0,36413,3,36416,0
7307,36417,0,36417,3,36420,0
7308,36422,0,36422,3,36425,0
7309,36428,0,36428,3,36431,0
7310,36431,0,36431,3,36434,0
7310,36434,0,36434,3,36437,0
7311,36435,2,36437,3,36440,1
7310,36437,3,36440,3,36443,1
7312,36442,1,36443,3,36446,1
7311,36443,3,36446,3,36449,1
7311,36446,3,36449,3,36452,1
7313,36447,5,36452,3,36455,2
7312,36452,3,36455,3,36458,1
7314,36453,5,36458,3,36461,2
7313,36458,3,36461,3,36464,1
7315,36458,6,36464,3,36467,2
7313,36461,6,36467,3,36470,2
7316,36463,7,36470,3,36473,3
7313,36464,9,36473,3,36476,3
7317,36468,8,36476,3,36479,3
7315,36473,6,36479,3,36482,2
7318,36476,6,36482,3,36485,2
7319,36484,1,36485,3,36488,1
7320,36485,3,36488,3,36491,1
7320,36491,0,36491,3,36494,0
7321,36491,3,36494,3,36497,1
7320,36494,3,36497,3,36500,1
7322,36494,6,36500,3,36503,2
7320,36497,6,36503,3,36506,2
7323,36499,7,36506,3,36509,3
7320,36500,9,36509,3,36512,3
7324,36502,10,36512,3,36515,4
7325,36507,8,36515,3,36518,3
7326,36512,6,36518,3,36521,2
7324,36515,6,36521,3,36524,2
7327,36517,7,36524,3,36527,3
7328,36522,5,36527,3,36530,2
7329,36525,5,36530,3,36533,2
7330,36530,3,36533,3,36536,1
7331,36532,4,36536,3,36539,2
7332,36535,4,36539,3,36542,2
7333,36540,2,36542,3,36545,1
7332,36542,3,36545,3,36548,1
7334,36543,5,36548,3,36551,2
7335,36547,4,36551,3,36554,2
7336,36549,5,36554,3,36557,2
7337,36557,0,36557,3,36560,0
7337,36560,0,36560,3,36563,0
7338,36561,2,36563,3,36566,1
7338,36566,0,36566,3,36569,0
7339,36569,0,36569,3,36572,0
7340,36573,0,36573,3,36576,0
7341,36576,0,36576,3,36579,0
7342,36576,3,36579,3,36582,1
7341,36579,3,36582,3,36585,1
7343,36582,3,36585,3,36588,1
7344,36587,1,36588,3,36591,1
7345,36590,1,36591,3,36594,1
7345,36594,0,36594,3,36597,0
7346,36594,3,36597,3,36600,1
7347,36598,2,36600,3,36603,1
7348,36600,3,36603,3,36606,1
7347,36603,3,36606,3,36609,1
7349,36604,5,36609,3,36612,2
7350,36610,2,36612,3,36615,1
7351,36614,1,36615,3,36618,1
7352,36622,0,36622,3,36625,0
7353,36628,0,36628,3,36631,0
7354,36631,0,36631,3,36634,0
7355,36633,1,36634,3,36637,1
7354,36634,3,36637,3,36640,1
7356,36634,6,36640,3,36643,2
7357,36641,2,36643,3,36646,1
7358,36646,0,36646,3,36649,0
7359,36654,0,36654,3,36657,0
7360,36655,2,36657,3,36660,1
7361,36661,0,36661,3,36664,0
7361,36664,0,36664,3,36667,0
7362,36668,0,36668,3,36671,0
7363,36676,0,36676,3,36679,0
7363,36679,0,36679,3,36682,0
7364,36679,3,36682,3,36685,1
7365,36682,3,36685,3,36688,1
7365,36688,0,36688,3,36691,0
7366,36688,3,36691,3,36694,1
7367,36692,2,36694,3,36697,1
7368,36698,0,36698,3,36701,0
7369,36700,1,36701,3,36704,1
7368,36701,3,36704,3,36707,1
7368,36704,3,36707,3,36710,1
7368,36707,3,36710,3,36713,1
7370,36707,6,36713,3,36716,2
7370,36716,0,36716,3,36719,0
7371,36716,3,36719,3,36722,1
7372,36722,0,36722,3,36725,0
7373,36732,0,36732,3,36735,0
7373,36735,0,36735,3,36738,0
7374,36737,1,36738,3,36741,1
7373,36738,3,36741,3,36744,1
7373,36741,3,36744,3,36747,1
7375,36744,3,36747,3,36750,1
7374,36747,3,36750,3,36753,1
7376,36748,5,36753,3,36756,2
7374,36750,6,36756,3,36759,2
7377,36760,0,36760,3,36763,0
7378,36767,0,36767,3,36770,0
7379,36773,0,36773,3,36776,0
7380,36776,0,36776,3,36779,0
7381,36785,0,36785,3,36788,0
7382,36793,0,36793,3,36796,0
7382,36796,0,36796,3,36799,0
7383,36797,2,36799,3,36802,1
7383,36802,0,36802,3,36805,0
7384,36804,1,36805,3,36808,1
7385,36809,0,36809,3,36812,0
7385,36812,0,36812,3,36815,0
7386,36812,3,36815,3,36818,1
7387,36819,0,36819,3,36822,0
7388,36829,0,36829,3,36832,0
7389,36837,0,36837,3,36840,0
7389,36840,0,36840,3,36843,0
7390,36842,1,36843,3,36846,1
7389,36843,3,36846,3,36849,1
7389,36846,3,36849,3,36852,1
7391,36847,5,36852,3,36855,2
7389,36849,6,36855,3,36858,2
7392,36851,7,36858,3,36861,3
7390,36855,6,36861,3,36864,2
7393,36856,8,36864,3,36867,3
7390,36858,9,36867,3,36870,3
7390,36861,9,36870,3,36873,3
7394,36863,10,36873,3,36876,4
7395,36867,9,36876,3,36879,3
7396,36870,9,36879,3,36882,3
7397,36871,11,36882,3,36885,4
7393,36873,12,36885,3,36888,4
7398,36875,13,36888,3,36891,5
7393,36876,15,36891,3,36894,5
7393,36879,15,36894,3,36897,5
7399,36881,16,36897,3,36900,6
7394,36885,15,36900,3,36903,5
7400,36886,17,36903,3,36906,6
7401,36888,18,36906,3,36909,6
7402,36890,19,36909,3,36912,7
7403,36899,13,36912,3,36915,5
7404,36903,12,36915,3,36918,4
7405,36907,11,36918,3,36921,4
7406,36910,11,36921,3,36924,4
7403,36915,9,36924,3,36927,3
7407,36915,12,36927,3,36930,4
7404,36921,9,36930,3,36933,3
7408,36924,9,36933,3,36936,3
7405,36927,9,36936,3,36939,3
7409,36927,12,36939,3,36942,4
7410,36928,14,36942,3,36945,5
7411,36932,13,36945,3,36948,5
7412,36937,11,36948,3,36951,4
7408,36939,12,36951,3,36954,4
7413,36942,12,36954,3,36957,4
7410,36948,9,36957,3,36960,3
7414,36948,12,36960,3,36963,4
7415,36956,7,36963,3,36966,3
7416,36962,4,36966,3,36969,2
7414,36963,6,36969,3,36972,2
7417,36967,5,36972,3,36975,2
7418,36972,3,36975,3,36978,1
7419,36974,4,36978,3,36981,2
7420,36978,3,36981,3,36984,1
7419,36981,3,36984,3,36987,1
7421,36983,4,36987,3,36990,2
7422,36987,3,36990,3,36993,1
7423,36993,0,36993,3,36996,0
7424,37003,0,37003,3,37006,0
7424,37006,0,37006,3,37009,0
7425,37015,0,37015,3,37018,0
7426,37019,0,37019,3,37022,0
7427,37024,0,37024,3,37027,0
7427,37027,0,37027,3,37030,0
7428,37030,0,37030,3,37033,0
7428,37033,0,37033,3,37036,0
7429,37035,1,37036,3,37039,1
7430,37040,0,37040,3,37043,0
7431,37046,0,37046,3,37049,0
7432,37049,0,37049,3,37052,0
7433,37051,1,37052,3,37055,1
7433,37055,0,37055,3,37058,0
7434,37055,3,37058,3,37061,1
7434,37061,0,37061,3,37064,0
7435,37061,3,37064,3,37067,1
7434,37064,3,37067,3,37070,1
7436,37064,6,37070,3,37073,2
7437,37071,2,37073,3,37076,1
7438,37076,0,37076,3,37079,0
7438,37079,0,37079,3,37082,0
7438,37082,0,37082,3,37085,0
7439,37083,2,37085,3,37088,1
7439,37088,0,37088,3,37091,0
7440,37091,0,37091,3,37094,0
7441,37095,0,37095,3,37098,0
7442,37098,0,37098,3,37101,0
7443,37104,0,37104,3,37107,0
7444,37108,0,37108,3,37111,0
7445,37113,0,37113,3,37116,0
7446,37121,0,37121,3,37124,0
7447,37123,1,37124,3,37127,1
7446,37124,3,37127,3,37130,1
7446,37127,3,37130,3,37133,1
7448,37128,5,37133,3,37136,2
7449,37134,2,37136,3,37139,1
7450,37140,0,37140,3,37143,0
7451,37144,0,37144,3,37147,0
7452,37147,0,37147,3,37150,0
7453,37148,2,37150,3,37153,1
7452,37150,3,37153,3,37156,1
7454,37152,4,37156,3,37159,2
7453,37156,3,37159,3,37162,1
7453,37159,3,37162,3,37165,1
7455,37160,5,37165,3,37168,2
7453,37162,6,37168,3,37171,2
7453,37165,6,37171,3,37174,2
7456,37165,9,37174,3,37177,3
7457,37173,4,37177,3,37180,2
7456,37177,3,37180,3,37183,1
7458,37180,3,37183,3,37186,1
7459,37187,0,37187,3,37190,0
7460,37190,0,37190,3,37193,0
7461,37195,0,37195,3,37198,0
7462,37197,1,37198,3,37201,1
7461,37198,3,37201,3,37204,1
7461,37201,3,37204,3,37207,1
7463,37201,6,37207,3,37210,2
7461,37204,6,37210,3,37213,2
7464,37207,6,37213,3,37216,2
7462,37210,6,37216,3,37219,2
7465,37214,5,37219,3,37222,2
7466,37222,0,37222,3,37225,0
7467,37225,0,37225,3,37228,0
7468,37232,0,37232,3,37235,0
7468,37235,0,37235,3,37238,0
7469,37237,1,37238,3,37241,1
7468,37238,3,37241,3,37244,1
7470,37243,1,37244,3,37247,1
7471,37249,0,37249,3,37252,0
7471,37252,0,37252,3,37255,0
7472,37254,1,37255,3,37258,1
7473,37259,0,37259,3,37262,0
7474,37261,1,37262,3,37265,1
7475,37264,1,37265,3,37268,1
7474,37265,3,37268,3,37271,1
7476,37268,3,37271,3,37274,1
7477,37271,3,37274,3,37277,1
7478,37274,3,37277,3,37280,1
7479,37280,0,37280,3,37283,0
7480,37286,0,37286,3,37289,0
7480,37289,0,37289,3,37292,0
7481,37290,2,37292,3,37295,1
7480,37292,3,37295,3,37298,1
7482,37294,4,37298,3,37301,2
7483,37300,1,37301,3,37304,1
7484,37303,1,37304,3,37307,1
7485,37308,0,37308,3,37311,0
7485,37311,0,37311,3,37314,0
7486,37312,2,37314,3,37317,1
7485,37314,3,37317,3,37320,1
7485,37317,3,37320,3,37323,1
7487,37318,5,37323,3,37326,2
7488,37324,2,37326,3,37329,1
7489,37330,0,37330,3,37333,0
7490,37333,0,37333,3,37336,0
7491,37339,0,37339,3,37342,0
7492,37343,0,37343,3,37346,0
7493,37346,0,37346,3,37349,0
7494,37347,2,37349,3,37352,1
7494,37352,0,37352,3,37355,0
7495,37354,1,37355,3,37358,1
7496,37357,1,37358,3,37361,1
7495,37358,3,37361,3,37364,1
7495,37361,3,37364,3,37367,1
7497,37361,6,37367,3,37370,2
7495,37364,6,37370,3,37373,2
7498,37366,7,37373,3,37376,3
7495,37367,9,37376,3,37379,3
7495,37370,9,37379,3,37382,3
7499,37372,10,37382,3,37385,4
7496,37376,9,37385,3,37388,3
7500,37377,11,37388,3,37391,4
7501,37380,11,37391,3,37394,4
7497,37382,12,37394,3,37397,4
7502,37382,15,37397,3,37400,5
7503,37384,16,37400,3,37403,6
7504,37386,17,37403,3,37406,6
7505,37389,17,37406,3,37409,6
7506,37391,18,37409,3,37412,6
7500,37394,18,37412,3,37415,6
7507,37394,21,37415,3,37418,7
7508,37398,20,37418,3,37421,7
7509,37404,17,37421,3,37424,6
7510,37408,16,37424,3,37427,6
7511,37411,16,37427,3,37430,6
7505,37412,18,37430,3,37433,6
7512,37416,17,37433,3,37436,6
7513,37419,17,37436,3,37439,6
7507,37421,18,37439,3,37442,6
7508,37427,15,37442,3,37445,5
7514,37427,18,37445,3,37448,6
7509,37433,15,37448,3,37451,5
7515,37439,12,37451,3,37454,4
7516,37442,12,37454,3,37457,4
7512,37445,12,37457,3,37460,4
7517,37447,13,37460,3,37463,5
7518,37453,10,37463,3,37466,4
7519,37459,7,37466,3,37469,3
7516,37460,9,37469,3,37472,3
7520,37463,9,37472,3,37475,3
7517,37466,9,37475,3,37478,3
7521,37467,11,37478,3,37481,4
7517,37469,12,37481,3,37484,4
7522,37469,15,37484,3,37487,5
7523,37471,16,37487,3,37490,6
7524,37478,12,37490,3,37493,4
7520,37481,12,37493,3,37496,4
7525,37481,15,37496,3,37499,5
7526,37487,12,37499,3,37502,4
7523,37493,9,37502,3,37505,3
7523,37496,9,37505,3,37508,3
7527,37497,11,37508,3,37511,4
7528,37503,8,37511,3,37514,3
7529,37508,6,37514,3,37517,2
7530,37513,4,37517,3,37520,2
7531,37517,3,37520,3,37523,1
7530,37520,3,37523,3,37526,1
7532,37522,4,37526,3,37529,2
7531,37526,3,37529,3,37532,1
7533,37526,6,37532,3,37535,2
7534,37531,4,37535,3,37538,2
7532,37532,6,37538,3,37541,2
7532,37535,6,37541,3,37544,2
7535,37537,7,37544,3,37547,3
7532,37538,9,37547,3,37550,3
7533,37544,6,37550,3,37553,2
7533,37547,6,37553,3,37556,2
7536,37548,8,37556,3,37559,3
7537,37550,9,37559,3,37562,3
7534,37553,9,37562,3,37565,3
7538,37554,11,37565,3,37568,4
7539,37556,12,37568,3,37571,4
7540,37559,12,37571,3,37574,4
7536,37562,12,37574,3,37577,4
7537,37568,9,37577,3,37580,3
7541,37568,12,37580,3,37583,4
7542,37574,9,37583,3,37586,3
7543,37578,8,37586,3,37589,3
7540,37580,9,37589,3,37592,3
7540,37583,9,37592,3,37595,3
7544,37583,12,37595,3,37598,4
7540,37586,12,37598,3,37601,4
7545,37589,12,37601,3,37604,4
7541,37592,12,37604,3,37607,4
7541,37595,12,37607,3,37610,4
7546,37597,13,37610,3,37613,5
7547,37600,13,37613,3,37616,5
7542,37601,15,37616,3,37619,5
7548,37605,14,37619,3,37622,5
7549,37609,13,37622,3,37625,5
7545,37613,12,37625,3,37628,4
7550,37615,13,37628,3,37631,5
7551,37620,11,37631,3,37634,4
7552,37623,11,37634,3,37637,4
7548,37625,12,37637,3,37640,4
7548,37628,12,37640,3,37643,4
7553,37630,13,37643,3,37646,5
7554,37632,14,37646,3,37649,5
7549,37634,15,37649,3,37652,5
7555,37637,15,37652,3,37655,5
7550,37640,15,37655,3,37658,5
7556,37640,18,37658,3,37661,6
7551,37646,15,37661,3,37664,5
7557,37647,17,37664,3,37667,6
7551,37649,18,37667,3,37670,6
7558,37654,16,37670,3,37673,6
7552,37655,18,37673,3,37676,6
7559,37662,14,37676,3,37679,5
7560,37667,12,37679,3,37682,4
7561,37669,13,37682,3,37685,5
7556,37670,15,37685,3,37688,5
7556,37673,15,37688,3,37691,5
7562,37677,14,37691,3,37694,5
7557,37679,15,37694,3,37697,5
7563,37682,15,37697,3,37700,5
7559,37688,12,37700,3,37703,4
7564,37688,15,37703,3,37706,5
7559,37691,15,37706,3,37709,5
7565,37693,16,37709,3,37712,6
7559,37694,18,37712,3,37715,6
7559,37697,18,37715,3,37718,6
7566,37697,21,37718,3,37721,7
7560,37703,18,37721,3,37724,6
7567,37703,21,37724,3,37727,7
7560,37706,21,37727,3,37730,7
7568,37709,21,37730,3,37733,7
7569,37715,18,37733,3,37736,6
7570,37719,17,37736,3,37739,6
7565,37724,15,37739,3,37742,5
7571,37726,16,37742,3,37745,6
7565,37727,18,37745,3,37748,6
7572,37729,19,37748,3,37751,7
7565,37730,21,37751,3,37754,7
7565,37733,21,37754,3,37757,7
7565,37736,21,37757,3,37760,7
7573,37736,24,37760,3,37763,8
7566,37742,21,37763,3,37766,7
7574,37742,24,37766,3,37769,8
7567,37748,21,37769,3,37772,7
7575,37749,23,37772,3,37775,8
7568,37754,21,37775,3,37778,7
7576,37755,23,37778,3,37781,8
7568,37757,24,37781,3,37784,8
7577,37762,22,37784,3,37787,8
7578,37769,18,37787,3,37790,6
7579,37774,16,37790,3,37793,6
7580,37779,14,37793,3,37796,5
7581,37782,14,37796,3,37799,5
7582,37791,8,37799,3,37802,3
7583,37794,8,37802,3,37805,3
7584,37798,7,37805,3,37808,3
7581,37799,9,37808,3,37811,3
7585,37807,4,37811,3,37814,2
7583,37808,6,37814,3,37817,2
7586,37810,7,37817,3,37820,3
7584,37814,6,37820,3,37823,2
7587,37814,9,37823,3,37826,3
7588,37820,6,37826,3,37829,2
7586,37823,6,37829,3,37832,2
7589,37829,3,37832,3,37835,1
7589,37835,0,37835,3,37838,0
7590,37836,2,37838,3,37841,1
7589,37838,3,37841,3,37844,1
7591,37841,3,37844,3,37847,1
7592,37847,0,37847,3,37850,0
7592,37850,0,37850,3,37853,0
7593,37851,2,37853,3,37856,1
7592,37853,3,37856,3,37859,1
7594,37853,6,37859,3,37862,2
7595,37857,5,37862,3,37865,2
7596,37860,5,37865,3,37868,2
7595,37865,3,37868,3,37871,1
7597,37867,4,37871,3,37874,2
7595,37868,6,37874,3,37877,2
7595,37871,6,37877,3,37880,2
7598,37875,5,37880,3,37883,2
7596,37877,6,37883,3,37886,2
7599,37879,7,37886,3,37889,3
7596,37880,9,37889,3,37892,3
7600,37881,11,37892,3,37895,4
7601,37885,10,37895,3,37898,4
7597,37886,12,37898,3,37901,4
7602,37893,8,37901,3,37904,3
7599,37895,9,37904,3,37907,3
7603,37896,11,37907,3,37910,4
7599,37898,12,37910,3,37913,4
7604,37900,13,37913,3,37916,5
7605,37906,10,37916,3,37919,4
7606,37914,5,37919,3,37922,2
7606,37922,0,37922,3,37925,0
7607,37922,3,37925,3,37928,1
7608,37925,3,37928,3,37931,1
7609,37926,5,37931,3,37934,2
7608,37931,3,37934,3,37937,1
7610,37932,5,37937,3,37940,2
7608,37934,6,37940,3,37943,2
7608,37937,6,37943,3,37946,2
7611,37941,5,37946,3,37949,2
7612,37943,6,37949,3,37952,2
7613,37945,7,37952,3,37955,3
7614,37947,8,37955,3,37958,3
7615,37949,9,37958,3,37961,3
7613,37955,6,37961,3,37964,2
7616,37955,9,37964,3,37967,3
7614,37961,6,37967,3,37970,2
7617,37963,7,37970,3,37973,3
7615,37967,6,37973,3,37976,2
7618,37968,8,37976,3,37979,3
7619,37974,5,37979,3,37982,2
7617,37976,6,37982,3,37985,2
7620,37979,6,37985,3,37988,2
7621,37984,4,37988,3,37991,2
7622,37988,3,37991,3,37994,1
7623,37993,1,37994,3,37997,1
7623,37997,0,37997,3,38000,0
7624,37999,1,38000,3,38003,1
7623,38000,3,38003,3,38006,1
7625,38000,6,38006,3,38009,2
7626,38003,6,38009,3,38012,2
7627,38011,1,38012,3,38015,1
7628,38017,0,38017,3,38020,0
7629,38024,0,38024,3,38027,0
7630,38028,0,38028,3,38031,0
7631,38033,0,38033,3,38036,0
7631,38036,0,38036,3,38039,0
7632,38037,2,38039,3,38042,1
7631,38039,3,38042,3,38045,1
7633,38042,3,38045,3,38048,1
7634,38045,3,38048,3,38051,1
7633,38048,3,38051,3,38054,1
7635,38049,5,38054,3,38057,2
7633,38051,6,38057,3,38060,2
7636,38054,6,38060,3,38063,2
7637,38059,4,38063,3,38066,2
7635,38060,6,38066,3,38069,2
7638,38061,8,38069,3,38072,3
7639,38065,7,38072,3,38075,3
7640,38070,5,38075,3,38078,2
7641,38075,3,38078,3,38081,1
7642,38078,3,38081,3,38084,1
7641,38081,3,38084,3,38087,1
7643,38088,0,38088,3,38091,0
7644,38099,0,38099,3,38102,0
7645,38104,0,38104,3,38107,0
7646,38106,1,38107,3,38110,1
7647,38108,2,38110,3,38113,1
7648,38112,1,38113,3,38116,1
7649,38118,0,38118,3,38121,0
7650,38123,0,38123,3,38126,0
7651,38130,0,38130,3,38133,0
7651,38133,0,38133,3,38136,0
7652,38135,1,38136,3,38139,1
7651,38136,3,38139,3,38142,1
7653,38138,4,38142,3,38145,2
7651,38139,6,38145,3,38148,2
7654,38142,6,38148,3,38151,2
7652,38145,6,38151,3,38154,2
7655,38145,9,38154,3,38157,3
7653,38151,6,38157,3,38160,2
7653,38154,6,38160,3,38163,2
7656,38154,9,38163,3,38166,3
7657,38157,9,38166,3,38169,3
7658,38162,7,38169,3,38172,3
7659,38166,6,38172,3,38175,2
7658,38172,3,38175,3,38178,1
7660,38176,2,38178,3,38181,1
7659,38178,3,38181,3,38184,1
7661,38178,6,38184,3,38187,2
7662,38184,3,38187,3,38190,1
7662,38190,0,38190,3,38193,0
7663,38191,2,38193,3,38196,1
7664,38197,0,38197,3,38200,0
7665,38199,1,38200,3,38203,1
7665,38203,0,38203,3,38206,0
7666,38206,0,38206,3,38209,0
7666,38209,0,38209,3,38212,0
7667,38209,3,38212,3,38215,1
7668,38211,4,38215,3,38218,2
7667,38215,3,38218,3,38221,1
7669,38218,3,38221,3,38224,1
7670,38221,3,38224,3,38227,1
7671,38226,1,38227,3,38230,1
7672,38230,0,38230,3,38233,0
7673,38233,0,38233,3,38236,0
7673,38236,0,38236,3,38239,0
7674,38238,1,38239,3,38242,1
7674,38242,0,38242,3,38245,0
7675,38246,0,38246,3,38249,0
7676,38254,0,38254,3,38257,0
7677,38259,0,38259,3,38262,0
7678,38264,0,38264,3,38267,0
7678,38267,0,38267,3,38270,0
7679,38269,1,38270,3,38273,1
7680,38274,0,38274,3,38277,0
7681,38275,2,38277,3,38280,1
7681,38280,0,38280,3,38283,0
7682,38283,0,38283,3,38286,0
7683,38289,0,38289,3,38292,0
7684,38292,0,38292,3,38295,0
7685,38297,0,38297,3,38300,0
7686,38303,0,38303,3,38306,0
7687,38309,0,38309,3,38312,0
7687,38312,0,38312,3,38315,0
7688,38313,2,38315,3,38318,1
7689,38317,1,38318,3,38321,1
7690,38320,1,38321,3,38324,1
7691,38324,0,38324,3,38327,0
7692,38329,0,38329,3,38332,0
7692,38332,0,38332,3,38335,0
7693,38337,0,38337,3,38340,0
7694,38346,0,38346,3,38349,0
7694,38349,0,38349,3,38352,0
7695,38350,2,38352,3,38355,1
7694,38352,3,38355,3,38358,1
7696,38355,3,38358,3,38361,1
7697,38359,2,38361,3,38364,1
7698,38363,1,38364,3,38367,1
7697,38364,3,38367,3,38370,1
7697,38367,3,38370,3,38373,1
7699,38368,5,38373,3,38376,2
7700,38372,4,38376,3,38379,2
7698,38373,6,38379,3,38382,2
7701,38375,7,38382,3,38385,3
7702,38378,7,38385,3,38388,3
7703,38385,3,38388,3,38391,1
7704,38392,0,38392,3,38395,0
7705,38395,0,38395,3,38398,0
7706,38400,0,38400,3,38403,0
7707,38403,0,38403,3,38406,0
7708,38408,0,38408,3,38411,0
7709,38412,0,38412,3,38415,0
7710,38417,0,38417,3,38420,0
7711,38423,0,38423,3,38426,0
7712,38427,0,38427,3,38430,0
7713,38435,0,38435,3,38438,0
7713,38438,0,38438,3,38441,0
7714,38443,0,38443,3,38446,0
7715,38449,0,38449,3,38452,0
7716,38453,0,38453,3,38456,0
7716,38456,0,38456,3,38459,0
7717,38457,2,38459,3,38462,1
7718,38461,1,38462,3,38465,1
7719,38466,0,38466,3,38469,0
7719,38469,0,38469,3,38472,0
7720,38471,1,38472,3,38475,1
7720,38475,0,38475,3,38478,0
7721,38476,2,38478,3,38481,1
7720,38478,3,38481,3,38484,1
7722,38481,3,38484,3,38487,1
7723,38483,4,38487,3,38490,2
7721,38484,6,38490,3,38493,2
7724,38488,5,38493,3,38496,2
7725,38491,5,38496,3,38499,2
7726,38495,4,38499,3,38502,2
7727,38497,5,38502,3,38505,2
7728,38503,2,38505,3,38508,1
7727,38505,3,38508,3,38511,1
7729,38511,0,38511,3,38514,0
7730,38514,0,38514,3,38517,0
7730,38517,0,38517,3,38520,0
7730,38520,0,38520,3,38523,0
7731,38522,1,38523,3,38526,1
7731,38526,0,38526,3,38529,0
7732,38528,1,38529,3,38532,1
7732,38532,0,38532,3,38535,0
7733,38532,3,38535,3,38538,1
7734,38537,1,38538,3,38541,1
7733,38538,3,38541,3,38544,1
7733,38541,3,38544,3,38547,1
7735,38542,5,38547,3,38550,2
7734,38547,3,38550,3,38553,1
7734,38550,3,38553,3,38556,1
7736,38550,6,38556,3,38559,2
7735,38556,3,38559,3,38562,1
7737,38556,6,38562,3,38565,2
7735,38559,6,38565,3,38568,2
7738,38563,5,38568,3,38571,2
7739,38567,4,38571,3,38574,2
7737,38568,6,38574,3,38577,2
7740,38569,8,38577,3,38580,3
7741,38570,10,38580,3,38583,4
7739,38577,6,38583,3,38586,2
7742,38579,7,38586,3,38589,3
7743,38580,9,38589,3,38592,3
7740,38583,9,38592,3,38595,3
7744,38585,10,38595,3,38598,4
7741,38589,9,38598,3,38601,3
7745,38590,11,38601,3,38604,4
7746,38596,8,38604,3,38607,3
7743,38598,9,38607,3,38610,3
7747,38599,11,38610,3,38613,4
7748,38604,9,38613,3,38616,3
7749,38606,10,38616,3,38619,4
7746,38610,9,38619,3,38622,3
7750,38618,4,38622,3,38625,2
7748,38619,6,38625,3,38628,2
7751,38621,7,38628,3,38631,3
7748,38622,9,38631,3,38634,3
7752,38623,11,38634,3,38637,4
7748,38625,12,38637,3,38640,4
7753,38625,15,38640,3,38643,5
7754,38630,13,38643,3,38646,5
7755,38634,12,38646,3,38649,4
7756,38637,12,38649,3,38652,4
7753,38643,9,38652,3,38655,3
7754,38649,6,38655,3,38658,2
7757,38649,9,38658,3,38661,3
7758,38655,6,38661,3,38664,2
7756,38658,6,38664,3,38667,2
7756,38661,6,38667,3,38670,2
7759,38662,8,38670,3,38673,3
7756,38664,9,38673,3,38676,3
7760,38666,10,38676,3,38679,4
7756,38667,12,38679,3,38682,4
7761,38672,10,38682,3,38685,4
7762,38675,10,38685,3,38688,4
7763,38679,9,38688,3,38691,3
7760,38682,9,38691,3,38694,3
7761,38688,6,38694,3,38697,2
7764,38688,9,38697,3,38700,3
7765,38690,10,38700,3,38703,4
7766,38693,10,38703,3,38706,4
7767,38697,9,38706,3,38709,3
7768,38700,9,38709,3,38712,3
7769,38705,7,38712,3,38715,3
7766,38706,9,38715,3,38718,3
7770,38707,11,38718,3,38721,4
7771,38712,9,38721,3,38724,3
7768,38715,9,38724,3,38727,3
7772,38717,10,38727,3,38730,4
7769,38721,9,38730,3,38733,3
7773,38722,11,38733,3,38736,4
7774,38728,8,38736,3,38739,3
7771,38730,9,38739,3,38742,3
7771,38733,9,38742,3,38745,3
7775,38733,12,38745,3,38748,4
7776,38737,11,38748,3,38751,4
7772,38739,12,38751,3,38754,4
7777,38741,13,38754,3,38757,5
7778,38746,11,38757,3,38760,4
7779,38749,11,38760,3,38763,4
7780,38754,9,38763,3,38766,3
7777,38757,9,38766,3,38769,3
7781,38761,8,38769,3,38772,3
7779,38766,6,38772,3,38775,2
7782,38767,8,38775,3,38778,3
7783,38771,7,38778,3,38781,3
7780,38772,9,38781,3,38784,3
7784,38776,8,38784,3,38787,3
7785,38780,7,38787,3,38790,3
7782,38781,9,38790,3,38793,3
7786,38782,11,38793,3,38796,4
7782,38784,12,38796,3,38799,4
7787,38787,12,38799,3,38802,4
7788,38792,10,38802,3,38805,4
7785,38796,9,38805,3,38808,3
7785,38799,9,38808,3,38811,3
7789,38800,11,38811,3,38814,4
7790,38804,10,38814,3,38817,4
7791,38807,10,38817,3,38820,4
7787,38808,12,38820,3,38823,4
7792,38813,10,38823,3,38826,4
7793,38819,7,38826,3,38829,3
7792,38826,3,38829,3,38832,1
7794,38827,5,38832,3,38835,2
7793,38832,3,38835,3,38838,1
7795,38837,1,38838,3,38841,1
7796,38841,0,38841,3,38844,0
7797,38842,2,38844,3,38847,1
7798,38846,1,38847,3,38850,1
7798,38850,0,38850,3,38853,0
7799,38850,3,38853,3,38856,1
7799,38856,0,38856,3,38859,0
7800,38860,0,38860,3,38863,0
7801,38865,0,38865,3,38868,0
7802,38870,0,38870,3,38873,0
7802,38873,0,38873,3,38876,0
7803,38875,1,38876,3,38879,1
7804,38877,2,38879,3,38882,1
7805,38883,0,38883,3,38886,0
7806,38886,0,38886,3,38889,0
7807,38889,0,38889,3,38892,0
7808,38893,0,38893,3,38896,0
7808,38896,0,38896,3,38899,0
7809,38898,1,38899,3,38902,1
7810,38902,0,38902,3,38905,0
7811,38904,1,38905,3,38908,1
7812,38906,2,38908,3,38911,1
7811,38908,3,38911,3,38914,1
7813,38912,2,38914,3,38917,1
7814,38919,0,38919,3,38922,0
7815,38927,0,38927,3,38930,0
7815,38930,0,38930,3,38933,0
7816,38931,2,38933,3,38936,1
7817,38935,1,38936,3,38939,1
7817,38939,0,38939,3,38942,0
7818,38941,1,38942,3,38945,1
7818,38945,0,38945,3,38948,0
7819,38946,2,38948,3,38951,1
7820,38952,0,38952,3,38955,0
7821,38958,0,38958,3,38961,0
7821,38961,0,38961,3,38964,0
7822,38965,0,38965,3,38968,0
7823,38969,0,38969,3,38972,0
7823,38972,0,38972,3,38975,0
7824,38973,2,38975,3,38978,1
7823,38975,3,38978,3,38981,1
7825,38975,6,38981,3,38984,2
7823,38978,6,38984,3,38987,2
7826,38983,4,38987,3,38990,2
7824,38984,6,38990,3,38993,2
7827,38989,4,38993,3,38996,2
7826,38993,3,38996,3,38999,1
7828,38993,6,38999,3,39002,2
7829,39004,0,39004,3,39007,0
7830,39006,1,39007,3,39010,1
7831,39008,2,39010,3,39013,1
7832,39013,0,39013,3,39016,0
7832,39016,0,39016,3,39019,0
7833,39017,2,39019,3,39022,1
7834,39023,0,39023,3,39026,0
7835,39027,0,39027,3,39030,0
7836,39028,2,39030,3,39033,1
7837,39030,3,39033,3,39036,1
7836,39033,3,39036,3,39039,1
7838,39034,5,39039,3,39042,2
7836,39036,6,39042,3,39045,2
7839,39040,5,39045,3,39048,2
7840,39048,0,39048,3,39051,0
7841,39054,0,39054,3,39057,0
7842,39055,2,39057,3,39060,1
7842,39060,0,39060,3,39063,0
7843,39060,3,39063,3,39066,1
7844,39067,0,39067,3,39070,0
7845,39072,0,39072,3,39075,0
7846,39076,0,39076,3,39079,0
7847,39078,1,39079,3,39082,1
7848,39085,0,39085,3,39088,0
7849,39090,0,39090,3,39093,0
7850,39099,0,39099,3,39102,0
7850,39102,0,39102,3,39105,0
7851,39103,2,39105,3,39108,1
7850,39105,3,39108,3,39111,1
7852,39106,5,39111,3,39114,2
7853,39107,7,39114,3,39117,3
7850,39108,9,39117,3,39120,3
7854,39110,10,39120,3,39123,4
7850,39111,12,39123,3,39126,4
7855,39115,11,39126,3,39129,4
7851,39117,12,39129,3,39132,4
7856,39123,9,39132,3,39135,3
7853,39126,9,39135,3,39138,3
7857,39131,7,39138,3,39141,3
7855,39135,6,39141,3,39144,2
7858,39135,9,39144,3,39147,3
7855,39138,9,39147,3,39150,3
7859,39143,7,39150,3,39153,3
7857,39147,6,39153,3,39156,2
7860,39148,8,39156,3,39159,3
7861,39154,5,39159,3,39162,2
7859,39156,6,39162,3,39165,2
7862,39157,8,39165,3,39168,3
7859,39159,9,39168,3,39171,3
7859,39162,9,39171,3,39174,3
7863,39164,10,39174,3,39177,4
7864,39169,8,39177,3,39180,3
7865,39174,6,39180,3,39183,2
7866,39179,4,39183,3,39186,2
7867,39181,5,39186,3,39189,2
7868,39184,5,39189,3,39192,2
7866,39186,6,39192,3,39195,2
7869,39191,4,39195,3,39198,2
7867,39192,6,39198,3,39201,2
7870,39194,7,39201,3,39204,3
7868,39198,6,39204,3,39207,2
7871,39198,9,39207,3,39210,3
7872,39205,5,39210,3,39213,2
7873,39214,0,39214,3,39217,0
7874,39221,0,39221,3,39224,0
7875,39225,0,39225,3,39228,0
7876,39230,0,39230,3,39233,0
7877,39234,0,39234,3,39237,0
7878,39238,0,39238,3,39241,0
7879,39243,0,39243,3,39246,0
7880,39248,0,39248,3,39251,0
7881,39250,1,39251,3,39254,1
7882,39258,0,39258,3,39261,0
7882,39261,0,39261,3,39264,0
7883,39263,1,39264,3,39267,1
7884,39266,1,39267,3,39270,1
7883,39267,3,39270,3,39273,1
7883,39270,3,39273,3,39276,1
7885,39271,5,39276,3,39279,2
7883,39273,6,39279,3,39282,2
7883,39276,6,39282,3,39285,2
7886,39277,8,39285,3,39288,3
7887,39279,9,39288,3,39291,3
7884,39282,9,39291,3,39294,3
7888,39285,9,39294,3,39297,3
7885,39288,9,39297,3,39300,3
7885,39291,9,39300,3,39303,3
7889,39294,9,39303,3,39306,3
7890,39297,9,39306,3,39309,3
7891,39300,9,39309,3,39312,3
7888,39303,9,39312,3,39315,3
7888,39306,9,39315,3,39318,3
7892,39307,11,39318,3,39321,4
7893,39317,4,39321,3,39324,2
7894,39322,2,39324,3,39327,1
7895,39329,0,39329,3,39332,0
7896,39335,0,39335,3,39338,0
7896,39338,0,39338,3,39341,0
7897,39341,0,39341,3,39344,0
7898,39348,0,39348,3,39351,0
7899,39354,0,39354,3,39357,0
7900,39361,0,39361,3,39364,0
7901,39362,2,39364,3,39367,1
7900,39364,3,39367,3,39370,1
7902,39365,5,39370,3,39373,2
7903,39374,0,39374,3,39377,0
7903,39377,0,39377,3,39380,0
7904,39378,2,39380,3,39383,1
7905,39380,3,39383,3,39386,1
7906,39388,0,39388,3,39391,0
7906,39391,0,39391,3,39394,0
7907,39391,3,39394,3,39397,1
7908,39400,0,39400,3,39403,0
7908,39403,0,39403,3,39406,0
7909,39404,2,39406,3,39409,1
7908,39406,3,39409,3,39412,1
7910,39412,0,39412,3,39415,0
7911,39416,0,39416,3,39419,0
7911,39419,0,39419,3,39422,0
7912,39419,3,39422,3,39425,1
7913,39424,1,39425,3,39428,1
7914,39430,0,39430,3,39433,0
7914,39433,0,39433,3,39436,0
7915,39436,0,39436,3,39439,0
7915,39439,0,39439,3,39442,0
7916,39441,1,39442,3,39445,1
7917,39445,0,39445,3,39448,0
7918,39450,0,39450,3,39453,0
7919,39456,0,39456,3,39459,0
7920,39463,0,39463,3,39466,0
7921,39467,0,39467,3,39470,0
7922,39472,0,39472,3,39475,0
7923,39479,0,39479,3,39482,0
7924,39483,0,39483,3,39486,0
7924,39486,0,39486,3,39489,0
7925,39487,2,39489,3,39492,1
7924,39489,3,39492,3,39495,1
7926,39490,5,39495,3,39498,2
7924,39492,6,39498,3,39501,2
7927,39493,8,39501,3,39504,3
7924,39495,9,39504,3,39507,3
7924,39498,9,39507,3,39510,3
7928,39499,11,39510,3,39513,4
7929,39501,12,39513,3,39516,4
7930,39504,12,39516,3,39519,4
7931,39507,12,39519,3,39522,4
7932,39511,11,39522,3,39525,4
7933,39519,6,39525,3,39528,2
7934,39525,3,39528,3,39531,1
7935,39529,2,39531,3,39534,1
7936,39539,0,39539,3,39542,0
7936,39542,0,39542,3,39545,0
7937,39549,0,39549,3,39552,0
7937,39552,0,39552,3,39555,0
7938,39553,2,39555,3,39558,1
7939,39556,2,39558,3,39561,1
7940,39562,0,39562,3,39565,0
7941,39566,0,39566,3,39569,0
7942,39572,0,39572,3,39575,0
7942,39575,0,39575,3,39578,0
7943,39577,1,39578,3,39581,1
7944,39582,0,39582,3,39585,0
7945,39584,1,39585,3,39588,1
7946,39592,0,39592,3,39595,0
7947,39601,0,39601,3,39604,0
7948,39605,0,39605,3,39608,0
7949,39613,0,39613,3,39616,0
7950,39618,0,39618,3,39621,0
7951,39623,0,39623,3,39626,0
7951,39626,0,39626,3,39629,0
7952,39626,3,39629,3,39632,1
7951,39629,3,39632,3,39635,1
7953,39631,4,39635,3,39638,2
7954,39635,3,39638,3,39641,1
7955,39640,1,39641,3,39644,1
7956,39644,0,39644,3,39647,0
7957,39648,0,39648,3,39651,0
7957,39651,0,39651,3,39654,0
7958,39658,0,39658,3,39661,0
7959,39661,0,39661,3,39664,0
7960,39667,0,39667,3,39670,0
7960,39670,0,39670,3,39673,0
7961,39672,1,39673,3,39676,1
7960,39673,3,39676,3,39679,1
7962,39676,3,39679,3,39682,1
7961,39679,3,39682,3,39685,1
7963,39683,2,39685,3,39688,1
7964,39686,2,39688,3,39691,1
7963,39688,3,39691,3,39694,1
7965,39688,6,39694,3,39697,2
7966,39690,7,39697,3,39700,3
7967,39696,4,39700,3,39703,2
7968,39699,4,39703,3,39706,2
7969,39702,4,39706,3,39709,2
7970,39712,0,39712,3,39715,0
7971,39715,0,39715,3,39718,0
7972,39721,0,39721,3,39724,0
7973,39727,0,39727,3,39730,0
7974,39729,1,39730,3,39733,1
7975,39733,0,39733,3,39736,0
7976,39738,0,39738,3,39741,0
7977,39747,0,39747,3,39750,0
7977,39750,0,39750,3,39753,0
7978,39751,2,39753,3,39756,1
7977,39753,3,39756,3,39759,1
7979,39755,4,39759,3,39762,2
7977,39756,6,39762,3,39765,2
7980,39756,9,39765,3,39768,3
7977,39759,9,39768,3,39771,3
7981,39760,11,39771,3,39774,4
7982,39765,9,39774,3,39777,3
7983,39770,7,39777,3,39780,3
7984,39776,4,39780,3,39783,2
7985,39782,1,39783,3,39786,1
7986,39788,0,39788,3,39791,0
7986,39791,0,39791,3,39794,0
7986,39794,0,39794,3,39797,0
7987,39800,0,39800,3,39803,0
7988,39805,0,39805,3,39808,0
7989,39807,1,39808,3,39811,1
7988,39808,3,39811,3,39814,1
7990,39811,3,39814,3,39817,1
7990,39817,0,39817,3,39820,0
7991,39817,3,39820,3,39823,1
7992,39819,4,39823,3,39826,2
7991,39823,3,39826,3,39829,1
7993,39824,5,39829,3,39832,2
7994,39826,6,39832,3,39835,2
7995,39830,5,39835,3,39838,2
7993,39832,6,39838,3,39841,2
7996,39834,7,39841,3,39844,3
7994,39838,6,39844,3,39847,2
7997,39841,6,39847,3,39850,2
7998,39846,4,39850,3,39853,2
7999,39850,3,39853,3,39856,1
8000,39858,0,39858,3,39861,0
8001,39861,0,39861,3,39864,0
8002,39861,3,39864,3,39867,1
8003,39866,1,39867,3,39870,1
8003,39870,0,39870,3,39873,0
8004,39871,2,39873,3,39876,1
8005,39878,0,39878,3,39881,0
8006,39886,0,39886,3,39889,0
8007,39888,1,39889,3,39892,1
8006,39889,3,39892,3,39895,1
8008,39891,4,39895,3,39898,2
8009,39896,2,39898,3,39901,1
8010,39905,0,39905,3,39908,0
8011,39912,0,39912,3,39915,0
8012,39917,0,39917,3,39920,0
8013,39921,0,39921,3,39924,0
8013,39924,0,39924,3,39927,0
8014,39926,1,39927,3,39930,1
8015,39930,0,39930,3,39933,0
8016,39941,0,39941,3,39944,0
8017,39946,0,39946,3,39949,0
8018,39949,0,39949,3,39952,0
8018,39952,0,39952,3,39955,0
8018,39955,0,39955,3,39958,0
8019,39957,1,39958,3,39961,1
8019,39961,0,39961,3,39964,0
8020,39964,0,39964,3,39967,0
8021,39969,0,39969,3,39972,0
8022,39974,0,39974,3,39977,0
8023,39985,0,39985,3,39988,0
8024,39987,1,39988,3,39991,1
8024,39991,0,39991,3,39994,0
8025,39992,2,39994,3,39997,1
8026,39997,0,39997,3,40000,0
8026,40000,0,40000,3,40003,0
8027,40003,0,40003,3,40006,0
8027,40006,0,40006,3,40009,0
8028,40016,0,40016,3,40019,0
8029,40021,0,40021,3,40024,0
8030,40027,0,40027,3,40030,0
8031,40037,0,40037,3,40040,0
8032,40047,0,40047,3,40050,0
8033,40054,0,40054,3,40057,0
8034,40058,0,40058,3,40061,0
8035,40066,0,40066,3,40069,0
8036,40073,0,40073,3,40076,0
8037,40074,2,40076,3,40079,1
8038,40079,0,40079,3,40082,0
8039,40083,0,40083,3,40086,0
8039,40086,0,40086,3,40089,0
8040,40091,0,40091,3,40094,0
8040,40094,0,40094,3,40097,0
8041,40098,0,40098,3,40101,0
8042,40101,0,40101,3,40104,0
8043,40108,0,40108,3,40111,0
8044,40121,0,40121,3,40124,0
8044,40124,0,40124,3,40127,0
8045,40125,2,40127,3,40130,1
8046,40131,0,40131,3,40134,0
8047,40134,0,40134,3,40137,0
8047,40137,0,40137,3,40140,0
8048,40139,1,40140,3,40143,1
8048,40143,0,40143,3,40146,0
8049,40145,1,40146,3,40149,1
8049,40149,0,40149,3,40152,0
8050,40154,0,40154,3,40157,0
8051,40159,0,40159,3,40162,0
8052,40160,2,40162,3,40165,1
8053,40166,0,40166,3,40169,0
8054,40172,0,40172,3,40175,0
8055,40179,0,40179,3,40182,0
8055,40182,0,40182,3,40185,0
8056,40182,3,40185,3,40188,1
8057,40187,1,40188,3,40191,1
8056,40188,3,40191,3,40194,1
8058,40192,2,40194,3,40197,1
8058,40197,0,40197,3,40200,0
8059,40198,2,40200,3,40203,1
8060,40201,2,40203,3,40206,1
8060,40206,0,40206,3,40209,0
8061,40207,2,40209,3,40212,1
8060,40209,3,40212,3,40215,1
8062,40213,2,40215,3,40218,1
8061,40215,3,40218,3,40221,1
8063,40220,1,40221,3,40224,1
8064,40228,0,40228,3,40231,0
8065,40231,0,40231,3,40234,0
8066,40234,0,40234,3,40237,0
8066,40237,0,40237,3,40240,0
8066,40240,0,40240,3,40243,0
8067,40240,3,40243,3,40246,1
8068,40248,0,40248,3,40251,0
8069,40250,1,40251,3,40254,1
8070,40253,1,40254,3,40257,1
8069,40254,3,40257,3,40260,1
8071,40260,0,40260,3,40263,0
8072,40266,0,40266,3,40269,0
8072,40269,0,40269,3,40272,0
8072,40272,0,40272,3,40275,0
8073,40272,3,40275,3,40278,1
8074,40277,1,40278,3,40281,1
8075,40280,1,40281,3,40284,1
8075,40284,0,40284,3,40287,0
8076,40284,3,40287,3,40290,1
8077,40291,0,40291,3,40294,0
8077,40294,0,40294,3,40297,0
8078,40294,3,40297,3,40300,1
8079,40298,2,40300,3,40303,1
8080,40304,0,40304,3,40307,0
8081,40310,0,40310,3,40313,0
8082,40317,0,40317,3,40320,0
8083,40324,0,40324,3,40327,0
8084,40330,0,40330,3,40333,0
8085,40334,0,40334,3,40337,0
8086,40337,0,40337,3,40340,0
8086,40340,0,40340,3,40343,0
8087,40342,1,40343,3,40346,1
8088,40347,0,40347,3,40350,0
8088,40350,0,40350,3,40353,0
8089,40350,3,40353,3,40356,1
8090,40352,4,40356,3,40359,2
8090,40359,0,40359,3,40362,0
8091,40359,3,40362,3,40365,1
8090,40362,3,40365,3,40368,1
8092,40362,6,40368,3,40371,2
8090,40365,6,40371,3,40374,2
8093,40372,2,40374,3,40377,1
8093,40377,0,40377,3,40380,0
8094,40378,2,40380,3,40383,1
8095,40382,1,40383,3,40386,1
8096,40384,2,40386,3,40389,1
8097,40389,0,40389,3,40392,0
8097,40392,0,40392,3,40395,0
8097,40395,0,40395,3,40398,0
8098,40396,2,40398,3,40401,1
8099,40404,0,40404,3,40407,0
8100,40407,0,40407,3,40410,0
8101,40412,0,40412,3,40415,0
8102,40414,1,40415,3,40418,1
8101,40415,3,40418,3,40421,1
8101,40418,3,40421,3,40424,1
8103,40418,6,40424,3,40427,2
8104,40425,2,40427,3,40430,1
8105,40429,1,40430,3,40433,1
8104,40430,3,40433,3,40436,1
8104,40433,3,40436,3,40439,1
8106,40434,5,40439,3,40442,2
8105,40439,3,40442,3,40445,1
8107,40443,2,40445,3,40448,1
8107,40448,0,40448,3,40451,0
8108,40448,3,40451,3,40454,1
8109,40453,1,40454,3,40457,1
8110,40457,0,40457,3,40460,0
8111,40462,0,40462,3,40465,0
8112,40471,0,40471,3,40474,0
8113,40477,0,40477,3,40480,0
8113,40480,0,40480,3,40483,0
8114,40482,1,40483,3,40486,1
8114,40486,0,40486,3,40489,0
8115,40488,1,40489,3,40492,1
8116,40494,0,40494,3,40497,0
8117,40502,0,40502,3,40505,0
8117,40505,0,40505,3,40508,0
8118,40505,3,40508,3,40511,1
8119,40509,2,40511,3,40514,1
8120,40514,0,40514,3,40517,0
8120,40517,0,40517,3,40520,0
8121,40517,3,40520,3,40523,1
8122,40523,0,40523,3,40526,0
8122,40526,0,40526,3,40529,0
8123,40527,2,40529,3,40532,1
8123,40532,0,40532,3,40535,0
8124,40532,3,40535,3,40538,1
8124,40538,0,40538,3,40541,0
8125,40538,3,40541,3,40544,1
8126,40544,0,40544,3,40547,0
8127,40551,0,40551,3,40554,0
8128,40556,0,40556,3,40559,0
8129,40565,0,40565,3,40568,0
8130,40569,0,40569,3,40572,0
8131,40574,0,40574,3,40577,0
8131,40577,0,40577,3,40580,0
8132,40577,3,40580,3,40583,1
8131,40580,3,40583,3,40586,1
8133,40582,4,40586,3,40589,2
8134,40589,0,40589,3,40592,0
8135,40592,0,40592,3,40595,0
8136,40597,0,40597,3,40600,0
8137,40598,2,40600,3,40603,1
8138,40607,0,40607,3,40610,0
8139,40608,2,40610,3,40613,1
8140,40619,0,40619,3,40622,0
8141,40626,0,40626,3,40629,0
8142,40631,0,40631,3,40634,0
8143,40636,0,40636,3,40639,0
8144,40637,2,40639,3,40642,1
8145,40646,0,40646,3,40649,0
8146,40651,0,40651,3,40654,0
8147,40656,0,40656,3,40659,0
8148,40660,0,40660,3,40663,0
8148,40663,0,40663,3,40666,0
8149,40665,1,40666,3,40669,1
8148,40666,3,40669,3,40672,1
8148,40669,3,40672,3,40675,1
8150,40669,6,40675,3,40678,2
8151,40671,7,40678,3,40681,3
8152,40677,4,40681,3,40684,2
8150,40678,6,40684,3,40687,2
8150,40681,6,40687,3,40690,2
8153,40681,9,40690,3,40693,3
8154,40684,9,40693,3,40696,3
8155,40686,10,40696,3,40699,4
8156,40690,9,40699,3,40702,3
8157,40693,9,40702,3,40705,3
8158,40700,5,40705,3,40708,2
8158,40708,0,40708,3,40711,0
8159,40708,3,40711,3,40714,1
8160,40711,3,40714,3,40717,1
8161,40716,1,40717,3,40720,1
8162,40723,0,40723,3,40726,0
8163,40728,0,40728,3,40731,0
8164,40736,0,40736,3,40739,0
8164,40739,0,40739,3,40742,0
8165,40739,3,40742,3,40745,1
8165,40745,0,40745,3,40748,0
8166,40745,3,40748,3,40751,1
8166,40751,0,40751,3,40754,0
8167,40751,3,40754,3,40757,1
8168,40753,4,40757,3,40760,2
8169,40759,1,40760,3,40763,1
8170,40763,0,40763,3,40766,0
8171,40765,1,40766,3,40769,1
8170,40766,3,40769,3,40772,1
8170,40769,3,40772,3,40775,1
8172,40770,5,40775,3,40778,2
8171,40775,3,40778,3,40781,1
8171,40778,3,40781,3,40784,1
8173,40780,4,40784,3,40787,2
8172,40784,3,40787,3,40790,1
8174,40785,5,40790,3,40793,2
8172,40787,6,40793,3,40796,2
8172,40790,6,40796,3,40799,2
8175,40790,9,40799,3,40802,3
8176,40797,5,40802,3,40805,2
8177,40799,6,40805,3,40808,2
8176,40805,3,40808,3,40811,1
8178,40805,6,40811,3,40814,2
8179,40807,7,40814,3,40817,3
8177,40811,6,40817,3,40820,2
8178,40817,3,40820,3,40823,1
8180,40818,5,40823,3,40826,2
8179,40823,3,40826,3,40829,1
8181,40824,5,40829,3,40832,2
8179,40826,6,40832,3,40835,2
8179,40829,6,40835,3,40838,2
8182,40830,8,40838,3,40841,3
8179,40832,9,40841,3,40844,3
8183,40832,12,40844,3,40847,4
8179,40835,12,40847,3,40850,4
8179,40838,12,40850,3,40853,4
8184,40839,14,40853,3,40856,5
8179,40841,15,40856,3,40859,5
8185,40844,15,40859,3,40862,5
8182,40853,9,40862,3,40865,3
8186,40853,12,40865,3,40868,4
8183,40859,9,40868,3,40871,3
8187,40859,12,40871,3,40874,4
8188,40865,9,40874,3,40877,3
8189,40869,8,40877,3,40880,3
8190,40874,6,40880,3,40883,2
8191,40877,6,40883,3,40886,2
8189,40880,6,40886,3,40889,2
8192,40883,6,40889,3,40892,2
8193,40887,5,40892,3,40895,2
8191,40889,6,40895,3,40898,2
8194,40890,8,40898,3,40901,3
8195,40898,3,40901,3,40904,1
8195,40904,0,40904,3,40907,0
8196,40906,1,40907,3,40910,1
8197,40908,2,40910,3,40913,1
8196,40910,3,40913,3,40916,1
8198,40916,0,40916,3,40919,0
8199,40917,2,40919,3,40922,1
8200,40921,1,40922,3,40925,1
8200,40925,0,40925,3,40928,0
8201,40926,2,40928,3,40931,1
8202,40929,2,40931,3,40934,1
8203,40934,0,40934,3,40937,0
8204,40937,0,40937,3,40940,0
8204,40940,0,40940,3,40943,0
8205,40941,2,40943,3,40946,1
8206,40947,0,40947,3,40950,0
8206,40950,0,40950,3,40953,0
8207,40950,3,40953,3,40956,1
8208,40954,2,40956,3,40959,1
8207,40956,3,40959,3,40962,1
8207,40959,3,40962,3,40965,1
8209,40962,3,40965,3,40968,1
8210,40965,3,40968,3,40971,1
8211,40969,2,40971,3,40974,1
8210,40971,3,40974,3,40977,1
8212,40973,4,40977,3,40980,2
8213,40976,4,40980,3,40983,2
8211,40977,6,40983,3,40986,2
8214,40982,4,40986,3,40989,2
8212,40983,6,40989,3,40992,2
8215,40984,8,40992,3,40995,3
8216,40991,4,40995,3,40998,2
8215,40995,3,40998,3,41001,1
8217,40996,5,41001,3,41004,2
8215,40998,6,41004,3,41007,2
8216,41004,3,41007,3,41010,1
8218,41004,6,41010,3,41013,2
8219,41008,5,41013,3,41016,2
8220,41017,0,41017,3,41020,0
8220,41020,0,41020,3,41023,0
8221,41025,0,41025,3,41028,0
8222,41030,0,41030,3,41033,0
8223,41037,0,41037,3,41040,0
8223,41040,0,41040,3,41043,0
8223,41043,0,41043,3,41046,0
8224,41043,3,41046,3,41049,1
8225,41046,3,41049,3,41052,1
8226,41052,0,41052,3,41055,0
8227,41057,0,41057,3,41060,0
8228,41063,0,41063,3,41066,0
8229,41065,1,41066,3,41069,1
8228,41066,3,41069,3,41072,1
8230,41068,4,41072,3,41075,2
8228,41069,6,41075,3,41078,2
8231,41072,6,41078,3,41081,2
8229,41075,6,41081,3,41084,2
8232,41077,7,41084,3,41087,3
8233,41081,6,41087,3,41090,2
8234,41082,8,41090,3,41093,3
8235,41086,7,41093,3,41096,3
8233,41090,6,41096,3,41099,2
8236,41090,9,41099,3,41102,3
8237,41099,3,41102,3,41105,1
8238,41103,2,41105,3,41108,1
8239,41111,0,41111,3,41114,0
8240,41115,0,41115,3,41118,0
8241,41120,0,41120,3,41123,0
8242,41129,0,41129,3,41132,0
8242,41132,0,41132,3,41135,0
8243,41133,2,41135,3,41138,1
8243,41138,0,41138,3,41141,0
8244,41139,2,41141,3,41144,1
8244,41144,0,41144,3,41147,0
8245,41144,3,41147,3,41150,1
8244,41147,3,41150,3,41153,1
8246,41156,0,41156,3,41159,0
8247,41159,0,41159,3,41162,0
8248,41164,0,41164,3,41167,0
8249,41167,0,41167,3,41170,0
8250,41174,0,41174,3,41177,0
8251,41179,0,41179,3,41182,0
8252,41180,2,41182,3,41185,1
8251,41182,3,41185,3,41188,1
8253,41184,4,41188,3,41191,2
8254,41186,5,41191,3,41194,2
8255,41189,5,41194,3,41197,2
8256,41192,5,41197,3,41200,2
8254,41194,6,41200,3,41203,2
8257,41197,6,41203,3,41206,2
8256,41203,3,41206,3,41209,1
8258,41208,1,41209,3,41212,1
8259,41211,1,41212,3,41215,1
8258,41212,3,41215,3,41218,1
8260,41217,1,41218,3,41221,1
8259,41218,3,41221,3,41224,1
8261,41221,3,41224,3,41227,1
8262,41228,0,41228,3,41231,0
8263,41232,0,41232,3,41235,0
8264,41237,0,41237,3,41240,0
8264,41240,0,41240,3,41243,0
8265,41241,2,41243,3,41246,1
8266,41243,3,41246,3,41249,1
8267,41247,2,41249,3,41252,1
8267,41252,0,41252,3,41255,0
8268,41257,0,41257,3,41260,0
8269,41260,0,41260,3,41263,0
8270,41266,0,41266,3,41269,0
8271,41273,0,41273,3,41276,0
8271,41276,0,41276,3,41279,0
8271,41279,0,41279,3,41282,0
8272,41279,3,41282,3,41285,1
8271,41282,3,41285,3,41288,1
8273,41287,1,41288,3,41291,1
8272,41288,3,41291,3,41294,1
8274,41293,1,41294,3,41297,1
8275,41296,1,41297,3,41300,1
8276,41300,0,41300,3,41303,0
8277,41306,0,41306,3,41309,0
8278,41309,0,41309,3,41312,0
8279,41315,0,41315,3,41318,0
8279,41318,0,41318,3,41321,0
8279,41321,0,41321,3,41324,0
8280,41321,3,41324,3,41327,1
8279,41324,3,41327,3,41330,1
8281,41327,3,41330,3,41333,1
8282,41332,1,41333,3,41336,1
8281,41333,3,41336,3,41339,1
8283,41339,0,41339,3,41342,0
8284,41345,0,41345,3,41348,0
8285,41348,0,41348,3,41351,0
8286,41353,0,41353,3,41356,0
8286,41356,0,41356,3,41359,0
8287,41358,1,41359,3,41362,1
8286,41359,3,41362,3,41365,1
8286,41362,3,41365,3,41368,1
8288,41366,2,41368,3,41371,1
8287,41368,3,41371,3,41374,1
8289,41371,3,41374,3,41377,1
8290,41374,3,41377,3,41380,1
8289,41377,3,41380,3,41383,1
8291,41378,5,41383,3,41386,2
8292,41383,3,41386,3,41389,1
8293,41386,3,41389,3,41392,1
8294,41390,2,41392,3,41395,1
8295,41391,4,41395,3,41398,2
8294,41395,3,41398,3,41401,1
8296,41397,4,41401,3,41404,2
8295,41401,3,41404,3,41407,1
8297,41403,4,41407,3,41410,2
8295,41404,6,41410,3,41413,2
8298,41410,3,41413,3,41416,1
8299,41415,1,41416,3,41419,1
8299,41419,0,41419,3,41422,0
8300,41421,1,41422,3,41425,1
8301,41423,2,41425,3,41428,1
8302,41429,0,41429,3,41432,0
8303,41436,0,41436,3,41439,0
8303,41439,0,41439,3,41442,0
8304,41440,2,41442,3,41445,1
8304,41445,0,41445,3,41448,0
8305,41447,1,41448,3,41451,1
8306,41451,0,41451,3,41454,0
8307,41456,0,41456,3,41459,0
8308,41457,2,41459,3,41462,1
8309,41461,1,41462,3,41465,1
8308,41462,3,41465,3,41468,1
8310,41468,0,41468,3,41471,0
8310,41471,0,41471,3,41474,0
8311,41477,0,41477,3,41480,0
8311,41480,0,41480,3,41483,0
8312,41483,0,41483,3,41486,0
8313,41488,0,41488,3,41491,0
8314,41493,0,41493,3,41496,0
8315,41498,0,41498,3,41501,0
8316,41505,0,41505,3,41508,0
8317,41511,0,41511,3,41514,0
8318,41513,1,41514,3,41517,1
8317,41514,3,41517,3,41520,1
8318,41520,0,41520,3,41523,0
8319,41524,0,41524,3,41527,0
8320,41529,0,41529,3,41532,0
8320,41532,0,41532,3,41535,0
8321,41535,0,41535,3,41538,0
8322,41538,0,41538,3,41541,0
8323,41549,0,41549,3,41552,0
8323,41552,0,41552,3,41555,0
8324,41552,3,41555,3,41558,1
8323,41555,3,41558,3,41561,1
8325,41558,3,41561,3,41564,1
8326,41564,0,41564,3,41567,0
8327,41572,0,41572,3,41575,0
8328,41576,0,41576,3,41579,0
8329,41584,0,41584,3,41587,0
8329,41587,0,41587,3,41590,0
8330,41589,1,41590,3,41593,1
8329,41590,3,41593,3,41596,1
8329,41593,3,41596,3,41599,1
8331,41594,5,41599,3,41602,2
8329,41596,6,41602,3,41605,2
8329,41599,6,41605,3,41608,2
8332,41601,7,41608,3,41611,3
8329,41602,9,41611,3,41614,3
8333,41606,8,41614,3,41617,3
8334,41612,5,41617,3,41620,2
8335,41616,4,41620,3,41623,2
8336,41625,0,41625,3,41628,0
8337,41630,0,41630,3,41633,0
8337,41633,0,41633,3,41636,0
8338,41637,0,41637,3,41640,0
8338,41640,0,41640,3,41643,0
8339,41641,2,41643,3,41646,1
8338,41643,3,41646,3,41649,1
8340,41643,6,41649,3,41652,2
8341,41649,3,41652,3,41655,1
8340,41652,3,41655,3,41658,1
8342,41652,6,41658,3,41661,2
8343,41659,2,41661,3,41664,1
8342,41661,3,41664,3,41667,1
8342,41664,3,41667,3,41670,1
8344,41664,6,41670,3,41673,2
8342,41667,6,41673,3,41676,2
8345,41668,8,41676,3,41679,3
8346,41670,9,41679,3,41682,3
8347,41674,8,41682,3,41685,3
8348,41677,8,41685,3,41688,3
8345,41679,9,41688,3,41691,3
8349,41680,11,41691,3,41694,4
8350,41685,9,41694,3,41697,3
8348,41691,6,41697,3,41700,2
8351,41694,6,41700,3,41703,2
8349,41697,6,41703,3,41706,2
8352,41698,8,41706,3,41709,3
8350,41703,6,41709,3,41712,2
8353,41706,6,41712,3,41715,2
8354,41710,5,41715,3,41718,2
8352,41712,6,41718,3,41721,2
8355,41713,8,41721,3,41724,3
8356,41717,7,41724,3,41727,3
8357,41729,0,41729,3,41732,0
8358,41734,0,41734,3,41737,0
8358,41737,0,41737,3,41740,0
8359,41739,1,41740,3,41743,1
8358,41740,3,41743,3,41746,1
8358,41743,3,41746,3,41749,1
8360,41746,3,41749,3,41752,1
8361,41752,0,41752,3,41755,0
8362,41761,0,41761,3,41764,0
8363,41763,1,41764,3,41767,1
8362,41764,3,41767,3,41770,1
8364,41765,5,41770,3,41773,2
8362,41767,6,41773,3,41776,2
8365,41769,7,41776,3,41779,3
8362,41770,9,41779,3,41782,3
8362,41773,9,41782,3,41785,3
8366,41774,11,41785,3,41788,4
8367,41775,13,41788,3,41791,5
8363,41779,12,41791,3,41794,4
8368,41780,14,41794,3,41797,5
8369,41786,11,41797,3,41800,4
8370,41792,8,41800,3,41803,3
8371,41794,9,41803,3,41806,3
8372,41798,8,41806,3,41809,3
8373,41805,4,41809,3,41812,2
8374,41813,0,41813,3,41816,0
8375,41820,0,41820,3,41823,0
8376,41824,0,41824,3,41827,0
8377,41832,0,41832,3,41835,0
8377,41835,0,41835,3,41838,0
8378,41838,0,41838,3,41841,0
8379,41844,0,41844,3,41847,0
8380,41849,0,41849,3,41852,0
8380,41852,0,41852,3,41855,0
8381,41856,0,41856,3,41859,0
8382,41863,0,41863,3,41866,0
8382,41866,0,41866,3,41869,0
8383,41870,0,41870,3,41873,0
8384,41874,0,41874,3,41877,0
8385,41882,0,41882,3,41885,0
8386,41887,0,41887,3,41890,0
8387,41894,0,41894,3,41897,0
8388,41900,0,41900,3,41903,0
8389,41905,0,41905,3,41908,0
8389,41908,0,41908,3,41911,0
8390,41914,0,41914,3,41917,0
8390,41917,0,41917,3,41920,0
8391,41918,2,41920,3,41923,1
8390,41920,3,41923,3,41926,1
8390,41923,3,41926,3,41929,1
8392,41924,5,41929,3,41932,2
8393,41929,3,41932,3,41935,1
8394,41933,2,41935,3,41938,1
8393,41935,3,41938,3,41941,1
8395,41937,4,41941,3,41944,2
8394,41941,3,41944,3,41947,1
8396,41946,1,41947,3,41950,1
8396,41950,0,41950,3,41953,0
8397,41951,2,41953,3,41956,1
8398,41959,0,41959,3,41962,0
8399,41967,0,41967,3,41970,0
8400,41971,0,41971,3,41974,0
8401,41976,0,41976,3,41979,0
8402,41986,0,41986,3,41989,0
8403,41993,0,41993,3,41996,0
8404,41999,0,41999,3,42002,0
8404,42002,0,42002,3,42005,0
8405,42008,0,42008,3,42011,0
8405,42011,0,42011,3,42014,0
8406,42017,0,42017,3,42020,0
8407,42021,0,42021,3,42024,0
8407,42024,0,42024,3,42027,0
8408,42027,0,42027,3,42030,0
8409,42034,0,42034,3,42037,0
8410,42038,0,42038,3,42041,0
8411,42045,0,42045,3,42048,0
8412,42047,1,42048,3,42051,1
8411,42048,3,42051,3,42054,1
8413,42049,5,42054,3,42057,2
8411,42051,6,42057,3,42060,2
8414,42053,7,42060,3,42063,3
8411,42054,9,42063,3,42066,3
8412,42060,6,42066,3,42069,2
8415,42060,9,42069,3,42072,3
8416,42065,7,42072,3,42075,3
8414,42069,6,42075,3,42078,2
8417,42073,5,42078,3,42081,2
8415,42075,6,42081,3,42084,2
8418,42079,5,42084,3,42087,2
8416,42081,6,42087,3,42090,2
8419,42084,6,42090,3,42093,2
8420,42086,7,42093,3,42096,3
8421,42092,4,42096,3,42099,2
8422,42098,1,42099,3,42102,1
8422,42102,0,42102,3,42105,0
8423,42104,1,42105,3,42108,1
8424,42111,0,42111,3,42114,0
8425,42115,0,42115,3,42118,0
8426,42118,0,42118,3,42121,0
8426,42121,0,42121,3,42124,0
8427,42123,1,42124,3,42127,1
8426,42124,3,42127,3,42130,1
8428,42128,2,42130,3,42133,1
8429,42132,1,42133,3,42136,1
8430,42137,0,42137,3,42140,0
8430,42140,0,42140,3,42143,0
8431,42142,1,42143,3,42146,1
8431,42146,0,42146,3,42149,0
8432,42146,3,42149,3,42152,1
8431,42149,3,42152,3,42155,1
8433,42150,5,42155,3,42158,2
8431,42152,6,42158,3,42161,2
8434,42154,7,42161,3,42164,3
8432,42158,6,42164,3,42167,2
8435,42158,9,42167,3,42170,3
8436,42163,7,42170,3,42173,3
8434,42167,6,42173,3,42176,2
8437,42172,4,42176,3,42179,2
8438,42176,3,42179,3,42182,1
8439,42180,2,42182,3,42185,1
8438,42182,3,42185,3,42188,1
8440,42187,1,42188,3,42191,1
8439,42188,3,42191,3,42194,1
8441,42190,4,42194,3,42197,2
8442,42196,1,42197,3,42200,1
8441,42197,3,42200,3,42203,1
8441,42200,3,42203,3,42206,1
8443,42202,4,42206,3,42209,2
8444,42204,5,42209,3,42212,2
8445,42209,3,42212,3,42215,1
8446,42212,3,42215,3,42218,1
8445,42215,3,42218,3,42221,1
8447,42216,5,42221,3,42224,2
8448,42222,2,42224,3,42227,1
8449,42227,0,42227,3,42230,0
8449,42230,0,42230,3,42233,0
8450,42235,0,42235,3,42238,0
8451,42238,0,42238,3,42241,0
8451,42241,0,42241,3,42244,0
8451,42244,0,42244,3,42247,0
8452,42244,3,42247,3,42250,1
8453,42249,1,42250,3,42253,1
8452,42250,3,42253,3,42256,1
8454,42255,1,42256,3,42259,1
8454,42259,0,42259,3,42262,0
8455,42259,3,42262,3,42265,1
8456,42261,4,42265,3,42268,2
8457,42266,2,42268,3,42271,1
8456,42268,3,42271,3,42274,1
8458,42269,5,42274,3,42277,2
8456,42271,6,42277,3,42280,2
8456,42274,6,42280,3,42283,2
8456,42277,6,42283,3,42286,2
8459,42277,9,42286,3,42289,3
8460,42277,12,42289,3,42292,4
8461,42278,14,42292,3,42295,5
8462,42281,14,42295,3,42298,5
8457,42283,15,42298,3,42301,5
8463,42286,15,42301,3,42304,5
8464,42290,14,42304,3,42307,5
8465,42296,11,42307,3,42310,4
8466,42301,9,42310,3,42313,3
8464,42307,6,42313,3,42316,2
8467,42307,9,42316,3,42319,3
8464,42310,9,42319,3,42322,3
8464,42313,9,42322,3,42325,3
8468,42314,11,42325,3,42328,4
8469,42318,10,42328,3,42331,4
8465,42319,12,42331,3,42334,4
8470,42321,13,42334,3,42337,5
8466,42325,12,42337,3,42340,4
8471,42325,15,42340,3,42343,5
8472,42327,16,42343,3,42346,6
8467,42331,15,42346,3,42349,5
8473,42331,18,42349,3,42352,6
8467,42334,18,42352,3,42355,6
8474,42338,17,42355,3,42358,6
8469,42343,15,42358,3,42361,5
8475,42344,17,42361,3,42364,6
8476,42346,18,42364,3,42367,6
8477,42351,16,42367,3,42370,6
8471,42352,18,42370,3,42373,6
8478,42354,19,42373,3,42376,7
8479,42366,10,42376,3,42379,4
8476,42370,9,42379,3,42382,3
8480,42370,12,42382,3,42385,4
8476,42373,12,42385,3,42388,4
8481,42377,11,42388,3,42391,4
8482,42382,9,42391,3,42394,3
8479,42385,9,42394,3,42397,3
8483,42389,8,42397,3,42400,3
8480,42391,9,42400,3,42403,3
8484,42394,9,42403,3,42406,3
8485,42396,10,42406,3,42409,4
8486,42402,7,42409,3,42412,3
8487,42404,8,42412,3,42415,3
8485,42409,6,42415,3,42418,2
8488,42415,3,42418,3,42421,1
8487,42418,3,42421,3,42424,1
8489,42419,5,42424,3,42427,2
8490,42424,3,42427,3,42430,1
8491,42425,5,42430,3,42433,2
8492,42430,3,42433,3,42436,1
8493,42431,5,42436,3,42439,2
8494,42435,4,42439,3,42442,2
8492,42436,6,42442,3,42445,2
8495,42436,9,42445,3,42448,3
8496,42439,9,42448,3,42451,3
8497,42446,5,42451,3,42454,2
8496,42451,3,42454,3,42457,1
8498,42451,6,42457,3,42460,2
8496,42454,6,42460,3,42463,2
8499,42463,0,42463,3,42466,0
8499,42466,0,42466,3,42469,0
8500,42469,0,42469,3,42472,0
8501,42476,0,42476,3,42479,0
8502,42478,1,42479,3,42482,1
8503,42484,0,42484,3,42487,0
8504,42487,0,42487,3,42490,0
8505,42494,0,42494,3,42497,0
8506,42498,0,42498,3,42501,0
8506,42501,0,42501,3,42504,0
8506,42504,0,42504,3,42507,0
8507,42504,3,42507,3,42510,1
8507,42510,0,42510,3,42513,0
8508,42510,3,42513,3,42516,1
8508,42516,0,42516,3,42519,0
8509,42518,1,42519,3,42522,1
8509,42522,0,42522,3,42525,0
8510,42524,1,42525,3,42528,1
8509,42525,3,42528,3,42531,1
8509,42528,3,42531,3,42534,1
8511,42528,6,42534,3,42537,2
8509,42531,6,42537,3,42540,2
8512,42531,9,42540,3,42543,3
8513,42533,10,42543,3,42546,4
8509,42534,12,42546,3,42549,4
8514,42536,13,42549,3,42552,5
8515,42540,12,42552,3,42555,4
8516,42544,11,42555,3,42558,4
8512,42546,12,42558,3,42561,4
8517,42551,10,42561,3,42564,4
8518,42555,9,42564,3,42567,3
8519,42560,7,42567,3,42570,3
8516,42561,9,42570,3,42573,3
8520,42561,12,42573,3,42576,4
8521,42565,11,42576,3,42579,4
8522,42571,8,42579,3,42582,3
8519,42573,9,42582,3,42585,3
8523,42575,10,42585,3,42588,4
8521,42582,6,42588,3,42591,2
8524,42582,9,42591,3,42594,3
8525,42583,11,42594,3,42597,4
8522,42588,9,42597,3,42600,3
8526,42590,10,42600,3,42603,4
8527,42593,10,42603,3,42606,4
8528,42600,6,42606,3,42609,2
8529,42607,2,42609,3,42612,1
8530,42608,4,42612,3,42615,2
8529,42612,3,42615,3,42618,1
8531,42612,6,42618,3,42621,2
8530,42618,3,42621,3,42624,1
8532,42619,5,42624,3,42627,2
8533,42621,6,42627,3,42630,2
8534,42623,7,42630,3,42633,3
8535,42627,6,42633,3,42636,2
8536,42631,5,42636,3,42639,2
8537,42635,4,42639,3,42642,2
8538,42641,1,42642,3,42645,1
8537,42642,3,42645,3,42648,1
8537,42645,3,42648,3,42651,1
8539,42647,4,42651,3,42654,2
8540,42652,2,42654,3,42657,1
8540,42657,0,42657,3,42660,0
8541,42660,0,42660,3,42663,0
8541,42663,0,42663,3,42666,0
8542,42665,1,42666,3,42669,1
8543,42670,0,42670,3,42673,0
8543,42673,0,42673,3,42676,0
8544,42676,0,42676,3,42679,0
8545,42681,0,42681,3,42684,0
8546,42683,1,42684,3,42687,1
8547,42689,0,42689,3,42692,0
8547,42692,0,42692,3,42695,0
8548,42692,3,42695,3,42698,1
8549,42694,4,42698,3,42701,2
8548,42698,3,42701,3,42704,1
8550,42700,4,42704,3,42707,2
8551,42704,3,42707,3,42710,1
8552,42708,2,42710,3,42713,1
8553,42711,2,42713,3,42716,1
8554,42715,1,42716,3,42719,1
8553,42716,3,42719,3,42722,1
8555,42720,2,42722,3,42725,1
8555,42725,0,42725,3,42728,0
8556,42728,0,42728,3,42731,0
8557,42731,0,42731,3,42734,0
8558,42738,0,42738,3,42741,0
8559,42740,1,42741,3,42744,1
8560,42742,2,42744,3,42747,1
8559,42744,3,42747,3,42750,1
8560,42750,0,42750,3,42753,0
8561,42753,0,42753,3,42756,0
8562,42760,0,42760,3,42763,0
8563,42765,0,42765,3,42768,0
8563,42768,0,42768,3,42771,0
8564,42769,2,42771,3,42774,1
8564,42774,0,42774,3,42777,0
8565,42776,1,42777,3,42780,1
8564,42777,3,42780,3,42783,1
8566,42780,3,42783,3,42786,1
8567,42784,2,42786,3,42789,1
8568,42790,0,42790,3,42793,0
8569,42797,0,42797,3,42800,0
8570,42801,0,42801,3,42804,0
8571,42808,0,42808,3,42811,0
8571,42811,0,42811,3,42814,0
8572,42812,2,42814,3,42817,1
8572,42817,0,42817,3,42820,0
8573,42822,0,42822,3,42825,0
8574,42829,0,42829,3,42832,0
8574,42832,0,42832,3,42835,0
8575,42835,0,42835,3,42838,0
8575,42838,0,42838,3,42841,0
8576,42840,1,42841,3,42844,1
8575,42841,3,42844,3,42847,1
8577,42844,3,42847,3,42850,1
8578,42849,1,42850,3,42853,1
8579,42855,0,42855,3,42858,0
8580,42861,0,42861,3,42864,0
8580,42864,0,42864,3,42867,0
8581,42864,3,42867,3,42870,1
8582,42868,2,42870,3,42873,1
8583,42870,3,42873,3,42876,1
8584,42875,1,42876,3,42879,1
8585,42878,1,42879,3,42882,1
8586,42882,0,42882,3,42885,0
8587,42884,1,42885,3,42888,1
8586,42885,3,42888,3,42891,1
8588,42888,3,42891,3,42894,1
8588,42894,0,42894,3,42897,0
8589,42894,3,42897,3,42900,1
8590,42899,1,42900,3,42903,1
8591,42902,1,42903,3,42906,1
8592,42910,0,42910,3,42913,0
8593,42917,0,42917,3,42920,0
8594,42923,0,42923,3,42926,0
8595,42931,0,42931,3,42934,0
8596,42935,0,42935,3,42938,0
8597,42937,1,42938,3,42941,1
8598,42941,0,42941,3,42944,0
8598,42944,0,42944,3,42947,0
8599,42951,0,42951,3,42954,0
8599,42954,0,42954,3,42957,0
8600,42958,0,42958,3,42961,0
8600,42961,0,42961,3,42964,0
8601,42963,1,42964,3,42967,1
8602,42968,0,42968,3,42971,0
8603,42968,3,42971,3,42974,1
8602,42971,3,42974,3,42977,1
8602,42974,3,42977,3,42980,1
8604,42974,6,42980,3,42983,2
8602,42977,6,42983,3,42986,2
8602,42980,6,42986,3,42989,2
8605,42981,8,42989,3,42992,3
8603,42986,6,42992,3,42995,2
8603,42989,6,42995,3,42998,2
8606,42991,7,42998,3,43001,3
8607,42997,4,43001,3,43004,2
8605,42998,6,43004,3,43007,2
8608,43002,5,43007,3,43010,2
8606,43004,6,43010,3,43013,2
8609,43011,2,43013,3,43016,1
8608,43013,3,43016,3,43019,1
8610,43015,4,43019,3,43022,2
8609,43019,3,43022,3,43025,1
8611,43019,6,43025,3,43028,2
8612,43024,4,43028,3,43031,2
8613,43030,1,43031,3,43034,1
8614,43034,0,43034,3,43037,0
8615,43040,0,43040,3,43043,0
8616,43049,0,43049,3,43052,0
8616,43052,0,43052,3,43055,0
8617,43053,2,43055,3,43058,1
8618,43058,0,43058,3,43061,0
8619,43062,0,43062,3,43065,0
8620,43064,1,43065,3,43068,1
8620,43068,0,43068,3,43071,0
8621,43069,2,43071,3,43074,1
8622,43073,1,43074,3,43077,1
8621,43074,3,43077,3,43080,1
8623,43077,3,43080,3,43083,1
8624,43078,5,43083,3,43086,2
8625,43080,6,43086,3,43089,2
8626,43087,2,43089,3,43092,1
8627,43093,0,43093,3,43096,0
8628,43098,0,43098,3,43101,0
8629,43101,0,43101,3,43104,0
8630,43106,0,43106,3,43109,0
8631,43107,2,43109,3,43112,1
8630,43109,3,43112,3,43115,1
8632,43110,5,43115,3,43118,2
8633,43114,4,43118,3,43121,2
8631,43115,6,43121,3,43124,2
8634,43116,8,43124,3,43127,3
8632,43121,6,43127,3,43130,2
8635,43121,9,43130,3,43133,3
8636,43127,6,43133,3,43136,2
8637,43131,5,43136,3,43139,2
8638,43135,4,43139,3,43142,2
8636,43136,6,43142,3,43145,2
8639,43136,9,43145,3,43148,3
8640,43140,8,43148,3,43151,3
8641,43147,4,43151,3,43154,2
8642,43149,5,43154,3,43157,2
8643,43153,4,43157,3,43160,2
8644,43160,0,43160,3,43163,0
8645,43168,0,43168,3,43171,0
8646,43172,0,43172,3,43175,0
8647,43179,0,43179,3,43182,0
8648,43183,0,43183,3,43186,0
8649,43191,0,43191,3,43194,0
8649,43194,0,43194,3,43197,0
8650,43195,2,43197,3,43200,1
8650,43200,0,43200,3,43203,0
8651,43203,0,43203,3,43206,0
8652,43205,1,43206,3,43209,1
8651,43206,3,43209,3,43212,1
8653,43209,3,43212,3,43215,1
8654,43210,5,43215,3,43218,2
8655,43216,2,43218,3,43221,1
8655,43221,0,43221,3,43224,0
8656,43224,0,43224,3,43227,0
8657,43225,2,43227,3,43230,1
8658,43229,1,43230,3,43233,1
8659,43230,3,43233,3,43236,1
8660,43238,0,43238,3,43241,0
8661,43243,0,43243,3,43246,0
8662,43246,0,43246,3,43249,0
8663,43253,0,43253,3,43256,0
8664,43260,0,43260,3,43263,0
8665,43269,0,43269,3,43272,0
8666,43274,0,43274,3,43277,0
8667,43281,0,43281,3,43284,0
8668,43289,0,43289,3,43292,0
8669,43293,0,43293,3,43296,0
8670,43295,1,43296,3,43299,1
8671,43297,2,43299,3,43302,1
8672,43305,0,43305,3,43308,0
8673,43309,0,43309,3,43312,0
8674,43315,0,43315,3,43318,0
8675,43320,0,43320,3,43323,0
8676,43323,0,43323,3,43326,0
8677,43327,0,43327,3,43330,0
8677,43330,0,43330,3,43333,0
8678,43333,0,43333,3,43336,0
8679,43335,1,43336,3,43339,1
8680,43340,0,43340,3,43343,0
8680,43343,0,43343,3,43346,0
8681,43343,3,43346,3,43349,1
8682,43347,2,43349,3,43352,1
8681,43349,3,43352,3,43355,1
8683,43354,1,43355,3,43358,1
8684,43356,2,43358,3,43361,1
8685,43359,2,43361,3,43364,1
8685,43364,0,43364,3,43367,0
8686,43367,0,43367,3,43370,0
8687,43371,0,43371,3,43374,0
8688,43373,1,43374,3,43377,1
8687,43374,3,43377,3,43380,1
8687,43377,3,43380,3,43383,1
8689,43382,1,43383,3,43386,1
8690,43386,0,43386,3,43389,0
8691,43388,1,43389,3,43392,1
8691,43392,0,43392,3,43395,0
8692,43394,1,43395,3,43398,1
8692,43398,0,43398,3,43401,0
8693,43399,2,43401,3,43404,1
8694,43403,1,43404,3,43407,1
8693,43404,3,43407,3,43410,1
8693,43407,3,43410,3,43413,1
8695,43412,1,43413,3,43416,1
8696,43419,0,43419,3,43422,0
8696,43422,0,43422,3,43425,0
8697,43425,0,43425,3,43428,0
8697,43428,0,43428,3,43431,0
8698,43428,3,43431,3,43434,1
8699,43433,1,43434,3,43437,1
8700,43438,0,43438,3,43441,0
8701,43440,1,43441,3,43444,1
8702,43443,1,43444,3,43447,1
8703,43448,0,43448,3,43451,0
8704,43451,0,43451,3,43454,0
8705,43456,0,43456,3,43459,0
8705,43459,0,43459,3,43462,0
8706,43464,0,43464,3,43467,0
8706,43467,0,43467,3,43470,0
8707,43469,1,43470,3,43473,1
8708,43480,0,43480,3,43483,0
8709,43486,0,43486,3,43489,0
8710,43494,0,43494,3,43497,0
8711,43496,1,43497,3,43500,1
8712,43499,1,43500,3,43503,1
8713,43505,0,43505,3,43508,0
8713,43508,0,43508,3,43511,0
8714,43509,2,43511,3,43514,1
8715,43513,1,43514,3,43517,1
8716,43518,0,43518,3,43521,0
8716,43521,0,43521,3,43524,0
8717,43521,3,43524,3,43527,1
8716,43524,3,43527,3,43530,1
8716,43527,3,43530,3,43533,1
8718,43527,6,43533,3,43536,2
8716,43530,6,43536,3,43539,2
8719,43530,9,43539,3,43542,3
8716,43533,9,43542,3,43545,3
8720,43536,9,43545,3,43548,3
8721,43541,7,43548,3,43551,3
8722,43546,5,43551,3,43554,2
8723,43552,2,43554,3,43557,1
8723,43557,0,43557,3,43560,0
8724,43557,3,43560,3,43563,1
8725,43565,0,43565,3,43568,0
8726,43571,0,43571,3,43574,0
8726,43574,0,43574,3,43577,0
8727,43579,0,43579,3,43582,0
8727,43582,0,43582,3,43585,0
8727,43585,0,43585,3,43588,0
8727,43588,0,43588,3,43591,0
8728,43588,3,43591,3,43594,1
8727,43591,3,43594,3,43597,1
8729,43591,6,43597,3,43600,2
8730,43595,5,43600,3,43603,2
8728,43597,6,43603,3,43606,2
8731,43600,6,43606,3,43609,2
8732,43602,7,43609,3,43612,3
8733,43605,7,43612,3,43615,3
8734,43611,4,43615,3,43618,2
8732,43612,6,43618,3,43621,2
8732,43615,6,43621,3,43624,2
8735,43618,6,43624,3,43627,2
8736,43622,5,43627,3,43630,2
8734,43624,6,43630,3,43633,2
8737,43629,4,43633,3,43636,2
8735,43630,6,43636,3,43639,2
8737,43639,0,43639,3,43642,0
8738,43640,2,43642,3,43645,1
8739,43645,0,43645,3,43648,0
8740,43648,0,43648,3,43651,0
8741,43655,0,43655,3,43658,0
8742,43663,0,43663,3,43666,0
8742,43666,0,43666,3,43669,0
8743,43666,3,43669,3,43672,1
8742,43669,3,43672,3,43675,1
8744,43673,2,43675,3,43678,1
8743,43675,3,43678,3,43681,1
8745,43677,4,43681,3,43684,2
8745,43684,0,43684,3,43687,0
8746,43685,2,43687,3,43690,1
8745,43687,3,43690,3,43693,1
8747,43689,4,43693,3,43696,2
8748,43692,4,43696,3,43699,2
8749,43697,2,43699,3,43702,1
8750,43701,1,43702,3,43705,1
8750,43705,0,43705,3,43708,0
8751,43705,3,43708,3,43711,1
8752,43707,4,43711,3,43714,2
8753,43708,6,43714,3,43717,2
8751,43711,6,43717,3,43720,2
8754,43715,5,43720,3,43723,2
8755,43718,5,43723,3,43726,2
8756,43721,5,43726,3,43729,2
8757,43727,2,43729,3,43732,1
8756,43729,3,43732,3,43735,1
8758,43734,1,43735,3,43738,1
8759,43740,0,43740,3,43743,0
8759,43743,0,43743,3,43746,0
8759,43746,0,43746,3,43749,0
8760,43750,0,43750,3,43753,0
8761,43753,0,43753,3,43756,0
8762,43760,0,43760,3,43763,0
8763,43764,0,43764,3,43767,0
8764,43772,0,43772,3,43775,0
8765,43778,0,43778,3,43781,0
8765,43781,0,43781,3,43784,0
8765,43784,0,43784,3,43787,0
8766,43787,0,43787,3,43790,0
8767,43790,0,43790,3,43793,0
8768,43796,0,43796,3,43799,0
8769,43798,1,43799,3,43802,1
8770,43803,0,43803,3,43806,0
8771,43808,0,43808,3,43811,0
8771,43811,0,43811,3,43814,0
8772,43813,1,43814,3,43817,1
8773,43818,0,43818,3,43821,0
8773,43821,0,43821,3,43824,0
8774,43823,1,43824,3,43827,1
8775,43829,0,43829,3,43832,0
8776,43834,0,43834,3,43837,0
8777,43837,0,43837,3,43840,0
8777,43840,0,43840,3,43843,0
8778,43845,0,43845,3,43848,0
8779,43849,0,43849,3,43852,0
8780,43854,0,43854,3,43857,0
8781,43859,0,43859,3,43862,0
8782,43862,0,43862,3,43865,0
8783,43869,0,43869,3,43872,0
8784,43877,0,43877,3,43880,0
8785,43883,0,43883,3,43886,0
8786,43887,0,43887,3,43890,0
8786,43890,0,43890,3,43893,0
8787,43891,2,43893,3,43896,1
8788,43897,0,43897,3,43900,0
8789,43904,0,43904,3,43907,0
8790,43906,1,43907,3,43910,1
8789,43907,3,43910,3,43913,1
8791,43909,4,43913,3,43916,2
8792,43912,4,43916,3,43919,2
8791,43916,3,43919,3,43922,1
8793,43916,6,43922,3,43925,2
8794,43916,9,43925,3,43928,3
8795,43918,10,43928,3,43931,4
8791,43919,12,43931,3,43934,4
8791,43922,12,43934,3,43937,4
8796,43924,13,43937,3,43940,5
8797,43928,12,43940,3,43943,4
8798,43932,11,43943,3,43946,4
8799,43935,11,43946,3,43949,4
8800,43941,8,43949,3,43952,3
8801,43945,7,43952,3,43955,3
8799,43949,6,43955,3,43958,2
8802,43949,9,43958,3,43961,3
8803,43953,8,43961,3,43964,3
8804,43957,7,43964,3,43967,3
8805,43963,4,43967,3,43970,2
8806,43966,4,43970,3,43973,2
8807,43969,4,43973,3,43976,2
8808,43974,2,43976,3,43979,1
8809,43984,0,43984,3,43987,0
8810,43988,0,43988,3,43991,0
8811,44001,0,44001,3,44004,0
8811,44004,0,44004,3,44007,0
8812,44004,3,44007,3,44010,1
8813,44006,4,44010,3,44013,2
8811,44007,6,44013,3,44016,2
8811,44010,6,44016,3,44019,2
8814,44012,7,44019,3,44022,3
8815,44018,4,44022,3,44025,2
8816,44019,6,44025,3,44028,2
8817,44022,6,44028,3,44031,2
8815,44025,6,44031,3,44034,2
8818,44027,7,44034,3,44037,3
8819,44030,7,44037,3,44040,3
8820,44036,4,44040,3,44043,2
8821,44038,5,44043,3,44046,2
8819,44040,6,44046,3,44049,2
8820,44046,3,44049,3,44052,1
8822,44048,4,44052,3,44055,2
8823,44050,5,44055,3,44058,2
8824,44052,6,44058,3,44061,2
8822,44055,6,44061,3,44064,2
8822,44058,6,44064,3,44067,2
8825,44058,9,44067,3,44070,3
8826,44061,9,44070,3,44073,3
8827,44071,2,44073,3,44076,1
8828,44075,1,44076,3,44079,1
8829,44083,0,44083,3,44086,0
8829,44086,0,44086,3,44089,0
8829,44089,0,44089,3,44092,0
8829,44092,0,44092,3,44095,0
8830,44093,2,44095,3,44098,1
8829,44095,3,44098,3,44101,1
8831,44101,0,44101,3,44104,0
8831,44104,0,44104,3,44107,0
8832,44108,0,44108,3,44111,0
8833,44111,0,44111,3,44114,0
8834,44113,1,44114,3,44117,1
8834,44117,0,44117,3,44120,0
8835,44118,2,44120,3,44123,1
8836,44121,2,44123,3,44126,1
8837,44128,0,44128,3,44131,0
8838,44133,0,44133,3,44136,0
8839,44139,0,44139,3,44142,0
8840,44142,0,44142,3,44145,0
8841,44146,0,44146,3,44149,0
8842,44148,1,44149,3,44152,1
8841,44149,3,44152,3,44155,1
8843,44157,0,44157,3,44160,0
8844,44160,0,44160,3,44163,0
8845,44163,0,44163,3,44166,0
8846,44164,2,44166,3,44169,1
8847,44171,0,44171,3,44174,0
8848,44178,0,44178,3,44181,0
8849,44181,0,44181,3,44184,0
8850,44188,0,44188,3,44191,0
8850,44191,0,44191,3,44194,0
8850,44194,0,44194,3,44197,0
8851,44195,2,44197,3,44200,1
8852,44200,0,44200,3,44203,0
8853,44207,0,44207,3,44210,0
8854,44215,0,44215,3,44218,0
8855,44222,0,44222,3,44225,0
8856,44224,1,44225,3,44228,1
8855,44225,3,44228,3,44231,1
8855,44228,3,44231,3,44234,1
8857,44228,6,44234,3,44237,2
8858,44231,6,44237,3,44240,2
8859,44233,7,44240,3,44243,3
8860,44237,6,44243,3,44246,2
8858,44240,6,44246,3,44249,2
8858,44243,6,44249,3,44252,2
8861,44244,8,44252,3,44255,3
8858,44246,9,44255,3,44258,3
8862,44246,12,44258,3,44261,4
8863,44251,10,44261,3,44264,4
8864,44257,7,44264,3,44267,3
8861,44258,9,44267,3,44270,3
8865,44264,6,44270,3,44273,2
8866,44266,7,44273,3,44276,3
8867,44268,8,44276,3,44279,3
8865,44273,6,44279,3,44282,2
8868,44275,7,44282,3,44285,3
8865,44276,9,44285,3,44288,3
8869,44282,6,44288,3,44291,2
8870,44283,8,44291,3,44294,3
8867,44285,9,44294,3,44297,3
8868,44291,6,44297,3,44300,2
8871,44293,7,44300,3,44303,3
8868,44294,9,44303,3,44306,3
8872,44300,6,44306,3,44309,2
8873,44306,3,44309,3,44312,1
8872,44309,3,44312,3,44315,1
8874,44312,3,44315,3,44318,1
8875,44318,0,44318,3,44321,0
8875,44321,0,44321,3,44324,0
8876,44322,2,44324,3,44327,1
8875,44324,3,44327,3,44330,1
8877,44327,3,44330,3,44333,1
8878,44333,0,44333,3,44336,0
8879,44341,0,44341,3,44344,0
8880,44343,1,44344,3,44347,1
8880,44347,0,44347,3,44350,0
8881,44347,3,44350,3,44353,1
8880,44350,3,44353,3,44356,1
8882,44351,5,44356,3,44359,2
8883,44353,6,44359,3,44362,2
8884,44355,7,44362,3,44365,3
8881,44356,9,44365,3,44368,3
8881,44359,9,44368,3,44371,3
8885,44365,6,44371,3,44374,2
8886,44369,5,44374,3,44377,2
8887,44374,3,44377,3,44380,1
8888,44379,1,44380,3,44383,1
8889,44383,0,44383,3,44386,0
8890,44387,0,44387,3,44390,0
8891,44391,0,44391,3,44394,0
8891,44394,0,44394,3,44397,0
8892,44397,0,44397,3,44400,0
8893,44402,0,44402,3,44405,0
8894,44406,0,44406,3,44409,0
8895,44412,0,44412,3,44415,0
8896,44414,1,44415,3,44418,1
8897,44420,0,44420,3,44423,0
8897,44423,0,44423,3,44426,0
8898,44426,0,44426,3,44429,0
8899,44432,0,44432,3,44435,0
8900,44438,0,44438,3,44441,0
8900,44441,0,44441,3,44444,0
8900,44444,0,44444,3,44447,0
8901,44447,0,44447,3,44450,0
8902,44450,0,44450,3,44453,0
8902,44453,0,44453,3,44456,0
8902,44456,0,44456,3,44459,0
8903,44458,1,44459,3,44462,1
8903,44462,0,44462,3,44465,0
8904,44462,3,44465,3,44468,1
8905,44466,2,44468,3,44471,1
8904,44468,3,44471,3,44474,1
8906,44472,2,44474,3,44477,1
8907,44478,0,44478,3,44481,0
8907,44481,0,44481,3,44484,0
8907,44484,0,44484,3,44487,0
8908,44484,3,44487,3,44490,1
8909,44487,3,44490,3,44493,1
8908,44490,3,44493,3,44496,1
8908,44493,3,44496,3,44499,1
8910,44496,3,44499,3,44502,1
8911,44502,0,44502,3,44505,0
8912,44509,0,44509,3,44512,0
8912,44512,0,44512,3,44515,0
8913,44513,2,44515,3,44518,1
8914,44518,0,44518,3,44521,0
8915,44521,0,44521,3,44524,0
8916,44529,0,44529,3,44532,0
8916,44532,0,44532,3,44535,0
8917,44533,2,44535,3,44538,1
8916,44535,3,44538,3,44541,1
8918,44538,3,44541,3,44544,1
8919,44541,3,44544,3,44547,1
8920,44546,1,44547,3,44550,1
8921,44553,0,44553,3,44556,0
8922,44558,0,44558,3,44561,0
8923,44560,1,44561,3,44564,1
8922,44561,3,44564,3,44567,1
8924,44561,6,44567,3,44570,2
8925,44567,3,44570,3,44573,1
8925,44573,0,44573,3,44576,0
8926,44576,0,44576,3,44579,0
8927,44581,0,44581,3,44584,0
8928,44587,0,44587,3,44590,0
8928,44590,0,44590,3,44593,0
8929,44593,0,44593,3,44596,0
8930,44598,0,44598,3,44601,0
8931,44603,0,44603,3,44606,0
8931,44606,0,44606,3,44609,0
8932,44609,0,44609,3,44612,0
8933,44613,0,44613,3,44616,0
8934,44616,0,44616,3,44619,0
8935,44624,0,44624,3,44627,0
8936,44626,1,44627,3,44630,1
8937,44631,0,44631,3,44634,0
8937,44634,0,44634,3,44637,0
8938,44638,0,44638,3,44641,0
8939,44640,1,44641,3,44644,1
8940,44643,1,44644,3,44647,1
8939,44644,3,44647,3,44650,1
8941,44647,3,44650,3,44653,1
8942,44652,1,44653,3,44656,1
8943,44655,1,44656,3,44659,1
8942,44656,3,44659,3,44662,1
8944,44662,0,44662,3,44665,0
8945,44669,0,44669,3,44672,0
8946,44675,0,44675,3,44678,0
8946,44678,0,44678,3,44681,0
8947,44679,2,44681,3,44684,1
8948,44684,0,44684,3,44687,0
8949,44686,1,44687,3,44690,1
8950,44691,0,44691,3,44694,0
8951,44694,0,44694,3,44697,0
8952,44700,0,44700,3,44703,0
8953,44704,0,44704,3,44707,0
8954,44711,0,44711,3,44714,0
8954,44714,0,44714,3,44717,0
8955,44717,0,44717,3,44720,0
8956,44721,0,44721,3,44724,0
8957,44724,0,44724,3,44727,0
8958,44734,0,44734,3,44737,0
8959,44739,0,44739,3,44742,0
8959,44742,0,44742,3,44745,0
8960,44743,2,44745,3,44748,1
8959,44745,3,44748,3,44751,1
8961,44749,2,44751,3,44754,1
8962,44757,0,44757,3,44760,0
8963,44766,0,44766,3,44769,0
8964,44772,0,44772,3,44775,0
8965,44776,0,44776,3,44779,0
8965,44779,0,44779,3,44782,0
8966,44779,3,44782,3,44785,1
8967,44784,1,44785,3,44788,1
8966,44785,3,44788,3,44791,1
8968,44792,0,44792,3,44795,0
8969,44800,0,44800,3,44803,0
8969,44803,0,44803,3,44806,0
8970,44804,2,44806,3,44809,1
8970,44809,0,44809,3,44812,0
8971,44811,1,44812,3,44815,1
8972,44814,1,44815,3,44818,1
8972,44818,0,44818,3,44821,0
8973,44819,2,44821,3,44824,1
8972,44821,3,44824,3,44827,1
8974,44823,4,44827,3,44830,2
8975,44825,5,44830,3,44833,2
8976,44831,2,44833,3,44836,1
8977,44835,1,44836,3,44839,1
8976,44836,3,44839,3,44842,1
8978,44836,6,44842,3,44845,2
8976,44839,6,44845,3,44848,2
8979,44841,7,44848,3,44851,3
8977,44845,6,44851,3,44854,2
8980,44846,8,44854,3,44857,3
8981,44848,9,44857,3,44860,3
8982,44850,10,44860,3,44863,4
8978,44851,12,44863,3,44866,4
8983,44857,9,44866,3,44869,3
8980,44860,9,44869,3,44872,3
8980,44863,9,44872,3,44875,3
8984,44868,7,44875,3,44878,3
8981,44869,9,44878,3,44881,3
8985,44873,8,44881,3,44884,3
8986,44876,8,44884,3,44887,3
8987,44879,8,44887,3,44890,3
8984,44881,9,44890,3,44893,3
8988,44883,10,44893,3,44896,4
8984,44884,12,44896,3,44899,4
8989,44898,1,44899,3,44902,1
8990,44904,0,44904,3,44907,0
8991,44908,0,44908,3,44911,0
8991,44911,0,44911,3,44914,0
8992,44913,1,44914,3,44917,1
8993,44918,0,44918,3,44921,0
8994,44923,0,44923,3,44926,0
8994,44926,0,44926,3,44929,0
8995,44926,3,44929,3,44932,1
8996,44928,4,44932,3,44935,2
8994,44929,6,44935,3,44938,2
8996,44938,0,44938,3,44941,0
8997,44938,3,44941,3,44944,1
8998,44944,0,44944,3,44947,0
8999,44951,0,44951,3,44954,0
9000,44956,0,44956,3,44959,0
9001,44960,0,44960,3,44963,0
9002,44966,0,44966,3,44969,0
9002,44969,0,44969,3,44972,0
9003,44971,1,44972,3,44975,1
9003,44975,0,44975,3,44978,0
9004,44975,3,44978,3,44981,1
9005,44980,1,44981,3,44984,1
9004,44981,3,44984,3,44987,1
9006,44989,0,44989,3,44992,0
9007,44990,2,44992,3,44995,1
9006,44992,3,44995,3,44998,1
9008,44997,1,44998,3,45001,1
9009,45000,1,45001,3,45004,1
9009,45004,0,45004,3,45007,0
9009,45007,0,45007,3,45010,0
9010,45008,2,45010,3,45013,1
9010,45013,0,45013,3,45016,0
9011,45014,2,45016,3,45019,1
9011,45019,0,45019,3,45022,0
9012,45026,0,45026,3,45029,0
9012,45029,0,45029,3,45032,0
9013,45032,0,45032,3,45035,0
9014,45037,0,45037,3,45040,0
9015,45041,0,45041,3,45044,0
9016,45046,0,45046,3,45049,0
9017,45053,0,45053,3,45056,0
9018,45058,0,45058,3,45061,0
9018,45061,0,45061,3,45064,0
9018,45064,0,45064,3,45067,0
9019,45065,2,45067,3,45070,1
9020,45074,0,45074,3,45077,0
9021,45082,0,45082,3,45085,0
9021,45085,0,45085,3,45088,0
9022,45086,2,45088,3,45091,1
9021,45088,3,45091,3,45094,1
9021,45091,3,45094,3,45097,1
9023,45091,6,45097,3,45100,2
9022,45097,3,45100,3,45103,1
9024,45097,6,45103,3,45106,2
9023,45103,3,45106,3,45109,1
9025,45104,5,45109,3,45112,2
9026,45108,4,45112,3,45115,2
9025,45112,3,45115,3,45118,1
9027,45112,6,45118,3,45121,2
9028,45118,3,45121,3,45124,1
9028,45124,0,45124,3,45127,0
9029,45126,1,45127,3,45130,1
9028,45127,3,45130,3,45133,1
9030,45131,2,45133,3,45136,1
9031,45137,0,45137,3,45140,0
9032,45146,0,45146,3,45149,0
9033,45153,0,45153,3,45156,0
9034,45156,0,45156,3,45159,0
9035,45160,0,45160,3,45163,0
9035,45163,0,45163,3,45166,0
9036,45164,2,45166,3,45169,1
9036,45169,0,45169,3,45172,0
9037,45169,3,45172,3,45175,1
9038,45173,2,45175,3,45178,1
9039,45176,2,45178,3,45181,1
9040,45180,1,45181,3,45184,1
9041,45183,1,45184,3,45187,1
9041,45187,0,45187,3,45190,0
9042,45190,0,45190,3,45193,0
9043,45192,1,45193,3,45196,1
9044,45195,1,45196,3,45199,1
9044,45199,0,45199,3,45202,0
9045,45202,0,45202,3,45205,0
9046,45206,0,45206,3,45209,0
9047,45215,0,45215,3,45218,0
9047,45218,0,45218,3,45221,0
9048,45220,1,45221,3,45224,1
9048,45224,0,45224,3,45227,0
9049,45226,1,45227,3,45230,1
9050,45233,0,45233,3,45236,0
9051,45235,1,45236,3,45239,1
9050,45236,3,45239,3,45242,1
9052,45238,4,45242,3,45245,2
9050,45239,6,45245,3,45248,2
9050,45242,6,45248,3,45251,2
9053,45248,3,45251,3,45254,1
9052,45251,3,45254,3,45257,1
9052,45254,3,45257,3,45260,1
9054,45255,5,45260,3,45263,2
9052,45257,6,45263,3,45266,2
9055,45259,7,45266,3,45269,3
9052,45260,9,45269,3,45272,3
9056,45260,12,45272,3,45275,4
9052,45263,12,45275,3,45278,4
9057,45265,13,45278,3,45281,5
9052,45266,15,45281,3,45284,5
9052,45269,15,45284,3,45287,5
9058,45269,18,45287,3,45290,6
9059,45271,19,45290,3,45293,7
9052,45272,21,45293,3,45296,7
9053,45278,18,45296,3,45299,6
9060,45278,21,45299,3,45302,7
9061,45283,19,45302,3,45305,7
9055,45287,18,45305,3,45308,6
9062,45289,19,45308,3,45311,7
9056,45293,18,45311,3,45314,6
9063,45295,19,45314,3,45317,7
9057,45299,18,45317,3,45320,6
9064,45299,21,45320,3,45323,7
9065,45308,15,45323,3,45326,5
9066,45313,13,45326,3,45329,5
9067,45317,12,45329,3,45332,4
9068,45321,11,45332,3,45335,4
9069,45327,8,45335,3,45338,3
9066,45329,9,45338,3,45341,3
9070,45333,8,45341,3,45344,3
9067,45335,9,45344,3,45347,3
9071,45338,9,45347,3,45350,3
9072,45346,4,45350,3,45353,2
9073,45352,1,45353,3,45356,1
9074,45355,1,45356,3,45359,1
9074,45359,0,45359,3,45362,0
9075,45359,3,45362,3,45365,1
9076,45363,2,45365,3,45368,1
9077,45370,0,45370,3,45373,0
9078,45374,0,45374,3,45377,0
9079,45378,0,45378,3,45381,0
9079,45381,0,45381,3,45384,0
9080,45385,0,45385,3,45388,0
9081,45390,0,45390,3,45393,0
9082,45396,0,45396,3,45399,0
9083,45399,0,45399,3,45402,0
9084,45408,0,45408,3,45411,0
9085,45414,0,45414,3,45417,0
9086,45417,0,45417,3,45420,0
9087,45419,1,45420,3,45423,1
9088,45422,1,45423,3,45426,1
9088,45426,0,45426,3,45429,0
9089,45431,0,45431,3,45434,0
9090,45434,0,45434,3,45437,0
9091,45434,3,45437,3,45440,1
9092,45442,0,45442,3,45445,0
9092,45445,0,45445,3,45448,0
9093,45456,0,45456,3,45459,0
9094,45461,0,45461,3,45464,0
9095,45464,0,45464,3,45467,0
9096,45470,0,45470,3,45473,0
9097,45474,0,45474,3,45477,0
9097,45477,0,45477,3,45480,0
9097,45480,0,45480,3,45483,0
9098,45483,0,45483,3,45486,0
9099,45487,0,45487,3,45490,0
9099,45490,0,45490,3,45493,0
9100,45490,3,45493,3,45496,1
9101,45497,0,45497,3,45500,0
9102,45502,0,45502,3,45505,0
9103,45507,0,45507,3,45510,0
9104,45513,0,45513,3,45516,0
9105,45523,0,45523,3,45526,0
9106,45525,1,45526,3,45529,1
9106,45529,0,45529,3,45532,0
9106,45532,0,45532,3,45535,0
9107,45533,2,45535,3,45538,1
9108,45539,0,45539,3,45542,0
9109,45546,0,45546,3,45549,0
9110,45552,0,45552,3,45555,0
9111,45559,0,45559,3,45562,0
9112,45560,2,45562,3,45565,1
9113,45564,1,45565,3,45568,1
9113,45568,0,45568,3,45571,0
9114,45568,3,45571,3,45574,1
9115,45573,1,45574,3,45577,1
9116,45575,2,45577,3,45580,1
9116,45580,0,45580,3,45583,0
9117,45582,1,45583,3,45586,1
9118,45590,0,45590,3,45593,0
9119,45597,0,45597,3,45600,0
9120,45601,0,45601,3,45604,0
9120,45604,0,45604,3,45607,0
9121,45607,0,45607,3,45610,0
9122,45617,0,45617,3,45620,0
9123,45622,0,45622,3,45625,0
9124,45626,0,45626,3,45629,0
9124,45629,0,45629,3,45632,0
9124,45632,0,45632,3,45635,0
9125,45634,1,45635,3,45638,1
9125,45638,0,45638,3,45641,0
9126,45639,2,45641,3,45644,1
9127,45641,3,45644,3,45647,1
9127,45647,0,45647,3,45650,0
9128,45649,1,45650,3,45653,1
9129,45655,0,45655,3,45658,0
9130,45657,1,45658,3,45661,1
9129,45658,3,45661,3,45664,1
9131,45667,0,45667,3,45670,0
9132,45675,0,45675,3,45678,0
9132,45678,0,45678,3,45681,0
9132,45681,0,45681,3,45684,0
9133,45681,3,45684,3,45687,1
9132,45684,3,45687,3,45690,1
9134,45686,4,45690,3,45693,2
9135,45689,4,45693,3,45696,2
9134,45693,3,45696,3,45699,1
9136,45698,1,45699,3,45702,1
9135,45699,3,45702,3,45705,1
9135,45702,3,45705,3,45708,1
9137,45703,5,45708,3,45711,2
9138,45706,5,45711,3,45714,2
9139,45708,6,45714,3,45717,2
9137,45711,6,45717,3,45720,2
9140,45713,7,45720,3,45723,3
9137,45714,9,45723,3,45726,3
9141,45718,8,45726,3,45729,3
9139,45723,6,45729,3,45732,2
9139,45726,6,45732,3,45735,2
9142,45726,9,45735,3,45738,3
9143,45728,10,45738,3,45741,4
9139,45729,12,45741,3,45744,4
9144,45731,13,45744,3,45747,5
9139,45732,15,45747,3,45750,5
9139,45735,15,45750,3,45753,5
9145,45737,16,45753,3,45756,6
9140,45741,15,45756,3,45759,5
9140,45744,15,45759,3,45762,5
9146,45744,18,45762,3,45765,6
9140,45747,18,45765,3,45768,6
9140,45750,18,45768,3,45771,6
9147,45752,19,45771,3,45774,7
9148,45757,17,45774,3,45777,6
9149,45760,17,45777,3,45780,6
9144,45765,15,45780,3,45783,5
9150,45765,18,45783,3,45786,6
9146,45774,12,45786,3,45789,4
9151,45774,15,45789,3,45792,5
9152,45775,17,45792,3,45795,6
9153,45779,16,45795,3,45798,6
9154,45783,15,45798,3,45801,5
9155,45791,10,45801,3,45804,4
9151,45792,12,45804,3,45807,4
9156,45798,9,45807,3,45810,3
9153,45801,9,45810,3,45813,3
9157,45802,11,45813,3,45816,4
9153,45804,12,45816,3,45819,4
9158,45807,12,45819,3,45822,4
9155,45813,9,45822,3,45825,3
9159,45813,12,45825,3,45828,4
9160,45819,9,45828,3,45831,3
9157,45822,9,45831,3,45834,3
9161,45829,5,45834,3,45837,2
9160,45834,3,45837,3,45840,1
9162,45836,4,45840,3,45843,2
9161,45840,3,45843,3,45846,1
9163,45840,6,45846,3,45849,2
9161,45843,6,45849,3,45852,2
9164,45849,3,45852,3,45855,1
9165,45854,1,45855,3,45858,1
9164,45855,3,45858,3,45861,1
9166,45857,4,45861,3,45864,2
9164,45858,6,45864,3,45867,2
9167,45859,8,45867,3,45870,3
9164,45861,9,45870,3,45873,3
9168,45863,10,45873,3,45876,4
9169,45869,7,45876,3,45879,3
9166,45870,9,45879,3,45882,3
9170,45872,10,45882,3,45885,4
9171,45878,7,45885,3,45888,3
9172,45882,6,45888,3,45891,2
9171,45888,3,45891,3,45894,1
9173,45889,5,45894,3,45897,2
9174,45896,1,45897,3,45900,1
9175,45902,0,45902,3,45905,0
9176,45912,0,45912,3,45915,0
9176,45915,0,45915,3,45918,0
9176,45918,0,45918,3,45921,0
9177,45919,2,45921,3,45924,1
9178,45925,0,45925,3,45928,0
9179,45928,0,45928,3,45931,0
9180,45935,0,45935,3,45938,0
9180,45938,0,45938,3,45941,0
9181,45940,1,45941,3,45944,1
9180,45941,3,45944,3,45947,1
9182,45944,3,45947,3,45950,1
9183,45947,3,45950,3,45953,1
9183,45953,0,45953,3,45956,0
9183,45956,0,45956,3,45959,0
9184,45957,2,45959,3,45962,1
9185,45962,0,45962,3,45965,0
9185,45965,0,45965,3,45968,0
9186,45973,0,45973,3,45976,0
9187,45976,0,45976,3,45979,0
9188,45981,0,45981,3,45984,0
9189,45985,0,45985,3,45988,0
9190,45987,1,45988,3,45991,1
9190,45991,0,45991,3,45994,0
9191,45991,3,45994,3,45997,1
9192,45997,0,45997,3,46000,0
9192,46000,0,46000,3,46003,0
9193,46001,2,46003,3,46006,1
9193,46006,0,46006,3,46009,0
9194,46006,3,46009,3,46012,1
9195,46013,0,46013,3,46016,0
9196,46023,0,46023,3,46026,0
9196,46026,0,46026,3,46029,0
9197,46026,3,46029,3,46032,1
9198,46030,2,46032,3,46035,1
9197,46032,3,46035,3,46038,1
9199,46036,2,46038,3,46041,1
9200,46038,3,46041,3,46044,1
9201,46040,4,46044,3,46047,2
9199,46041,6,46047,3,46050,2
9199,46044,6,46050,3,46053,2
9199,46047,6,46053,3,46056,2
9202,46049,7,46056,3,46059,3
9199,46050,9,46059,3,46062,3
9199,46053,9,46062,3,46065,3
9203,46054,11,46065,3,46068,4
9204,46054,14,46068,3,46071,5
9205,46060,11,46071,3,46074,4
9206,46065,9,46074,3,46077,3
9207,46067,10,46077,3,46080,4
9208,46071,9,46080,3,46083,3
9209,46074,9,46083,3,46086,3
9210,46077,9,46086,3,46089,3
9211,46081,8,46089,3,46092,3
9212,46087,5,46092,3,46095,2
9210,46089,6,46095,3,46098,2
9213,46090,8,46098,3,46101,3
9214,46095,6,46101,3,46104,2
9215,46099,5,46104,3,46107,2
9213,46101,6,46107,3,46110,2
9213,46104,6,46110,3,46113,2
9216,46108,5,46113,3,46116,2
9217,46114,2,46116,3,46119,1
9216,46116,3,46119,3,46122,1
9218,46121,1,46122,3,46125,1
9219,46128,0,46128,3,46131,0
9219,46131,0,46131,3,46134,0
9220,46131,3,46134,3,46137,1
9221,46136,1,46137,3,46140,1
9222,46142,0,46142,3,46145,0
9222,46145,0,46145,3,46148,0
9223,46146,2,46148,3,46151,1
9224,46150,1,46151,3,46154,1
9223,46151,3,46154,3,46157,1
9225,46154,3,46157,3,46160,1
9224,46157,3,46160,3,46163,1
9226,46157,6,46163,3,46166,2
9224,46160,6,46166,3,46169,2
9224,46163,6,46169,3,46172,2
9227,46163,9,46172,3,46175,3
9224,46166,9,46175,3,46178,3
9228,46166,12,46178,3,46181,4
9229,46170,11,46181,3,46184,4
9225,46172,12,46184,3,46187,4
9230,46174,13,46187,3,46190,5
9231,46177,13,46190,3,46193,5
9232,46180,13,46193,3,46196,5
9233,46185,11,46196,3,46199,4
9229,46187,12,46199,3,46202,4
9234,46188,14,46202,3,46205,5
9230,46193,12,46205,3,46208,4
9235,46194,14,46208,3,46211,5
9236,46195,16,46211,3,46214,6
9230,46196,18,46214,3,46217,6
9237,46200,17,46217,3,46220,6
9238,46200,20,46220,3,46223,7
9233,46208,15,46223,3,46226,5
9239,46208,18,46226,3,46229,6
9240,46213,16,46229,3,46232,6
9241,46213,19,46232,3,46235,7
9234,46214,21,46235,3,46238,7
9242,46218,20,46238,3,46241,7
9243,46222,19,46241,3,46244,7
9244,46230,14,46244,3,46247,5
9239,46232,15,46247,3,46250,5
9245,46236,14,46250,3,46253,5
9240,46238,15,46253,3,46256,5
9240,46241,15,46256,3,46259,5
9246,46243,16,46259,3,46262,6
9240,46244,18,46262,3,46265,6
9240,46247,18,46265,3,46268,6
9247,46251,17,46268,3,46271,6
9248,46253,18,46271,3,46274,6
9242,46256,18,46274,3,46277,6
9249,46256,21,46277,3,46280,7
9250,46260,20,46280,3,46283,7
9251,46266,17,46283,3,46286,6
9245,46268,18,46286,3,46289,6
9252,46273,16,46289,3,46292,6
9253,46281,11,46292,3,46295,4
9249,46283,12,46295,3,46298,4
9254,46284,14,46298,3,46301,5
9255,46288,13,46301,3,46304,5
9250,46289,15,46304,3,46307,5
9256,46294,13,46307,3,46310,5
9251,46295,15,46310,3,46313,5
9257,46296,17,46313,3,46316,6
9258,46299,17,46316,3,46319,6
9252,46301,18,46319,3,46322,6
9259,46304,18,46322,3,46325,6
9260,46308,17,46325,3,46328,6
9254,46310,18,46328,3,46331,6
9261,46314,17,46331,3,46334,6
9255,46316,18,46334,3,46337,6
9262,46317,20,46337,3,46340,7
9256,46322,18,46340,3,46343,6
9263,46322,21,46343,3,46346,7
9264,46326,20,46346,3,46349,7
9257,46328,21,46349,3,46352,7
9265,46330,22,46352,3,46355,8
9266,46336,19,46355,3,46358,7
9267,46338,20,46358,3,46361,7
9261,46343,18,46361,3,46364,6
9268,46345,19,46364,3,46367,7
9262,46349,18,46367,3,46370,6
9269,46351,19,46370,3,46373,7
9270,46356,17,46373,3,46376,6
9271,46357,19,46376,3,46379,7
9272,46365,14,46379,3,46382,5
9273,46367,15,46382,3,46385,5
9274,46369,16,46385,3,46388,6
9268,46370,18,46388,3,46391,6
9275,46374,17,46391,3,46394,6
9276,46375,19,46394,3,46397,7
9277,46378,19,46397,3,46400,7
9278,46384,16,46400,3,46403,6
9279,46387,16,46403,3,46406,6
9280,46388,18,46406,3,46409,6
9281,46390,19,46409,3,46412,7
9274,46391,21,46412,3,46415,7
9274,46394,21,46415,3,46418,7
9282,46394,24,46418,3,46421,8
9283,46397,24,46421,3,46424,8
9284,46400,24,46424,3,46427,8
9285,46404,23,46427,3,46430,8
9277,46406,24,46430,3,46433,8
9286,46409,24,46433,3,46436,8
9287,46413,23,46436,3,46439,8
9279,46415,24,46439,3,46442,8
9288,46415,27,46442,3,46445,9
9279,46418,27,46445,3,46448,9
9289,46421,27,46448,3,46451,9
9280,46424,27,46451,3,46454,9
9290,46427,27,46454,3,46457,9
9291,46431,26,46457,3,46460,9
9292,46437,23,46460,3,46463,8
9284,46439,24,46463,3,46466,8
9293,46441,25,46466,3,46469,9
9286,46448,21,46469,3,46472,7
9294,46449,23,46472,3,46475,8
9295,46450,25,46475,3,46478,9
9286,46451,27,46478,3,46481,9
9296,46452,29,46481,3,46484,10
9286,46454,30,46484,3,46487,10
9297,46459,28,46487,3,46490,10
9287,46460,30,46490,3,46493,10
9298,46461,32,46493,3,46496,11
9299,46462,34,46496,3,46499,12
9287,46463,36,46499,3,46502,12
9300,46466,36,46502,3,46505,12
9301,46470,35,46505,3,46508,12
9302,46471,37,46508,3,46511,13
9303,46478,33,46511,3,46514,11
9304,46484,30,46514,3,46517,10
9305,46487,30,46517,3,46520,10
9295,46490,30,46520,3,46523,10
9306,46492,31,46523,3,46526,11
9295,46493,33,46526,3,46529,11
9295,46496,33,46529,3,46532,11
9307,46497,35,46532,3,46535,12
9308,46506,29,46535,3,46538,10
9298,46508,30,46538,3,46541,10
9309,46509,32,46541,3,46544,11
9299,46514,30,46544,3,46547,10
9310,46516,31,46547,3,46550,11
9311,46518,32,46550,3,46553,11
9300,46520,33,46553,3,46556,11
9312,46521,35,46556,3,46559,12
9301,46526,33,46559,3,46562,11
9313,46526,36,46562,3,46565,12
9314,46530,35,46565,3,46568,12
9303,46535,33,46568,3,46571,11
9315,46537,34,46571,3,46574,12
9303,46538,36,46574,3,46577,12
9304,46544,33,46577,3,46580,11
9316,46546,34,46580,3,46583,12
9304,46547,36,46583,3,46586,12
9317,46548,38,46586,3,46589,13
9318,46552,37,46589,3,46592,13
9306,46556,36,46592,3,46595,12
9306,46559,36,46595,3,46598,12
9319,46561,37,46598,3,46601,13
9320,46566,35,46601,3,46604,12
9308,46568,36,46604,3,46607,12
9321,46572,35,46607,3,46610,12
9322,46574,36,46610,3,46613,12
9323,46577,36,46613,3,46616,12
9311,46580,36,46616,3,46619,12
9324,46583,36,46619,3,46622,12
9325,46586,36,46622,3,46625,12
9326,46589,36,46625,3,46628,12
9327,46597,31,46628,3,46631,11
9317,46601,30,46631,3,46634,10
9328,46602,32,46634,3,46637,11
9329,46604,33,46637,3,46640,11
9318,46607,33,46640,3,46643,11
9330,46613,30,46643,3,46646,10
9331,46619,27,46646,3,46649,9
9332,46625,24,46649,3,46652,8
9324,46628,24,46652,3,46655,8
9333,46628,27,46655,3,46658,9
9325,46634,24,46658,3,46661,8
9334,46634,27,46661,3,46664,9
9335,46639,25,46664,3,46667,9
9336,46642,25,46667,3,46670,9
9337,46649,21,46670,3,46673,7
9338,46651,22,46673,3,46676,8
9331,46655,21,46676,3,46679,7
9339,46660,19,46679,3,46682,7
9333,46664,18,46682,3,46685,6
9340,46666,19,46685,3,46688,7
9335,46673,15,46688,3,46691,5
9341,46673,18,46691,3,46694,6
9342,46675,19,46694,3,46697,7
9343,46680,17,46697,3,46700,6
9337,46682,18,46700,3,46703,6
9337,46685,18,46703,3,46706,6
9344,46687,19,46706,3,46709,7
9338,46691,18,46709,3,46712,6
9345,46692,20,46712,3,46715,7
9346,46698,17,46715,3,46718,6
9340,46700,18,46718,3,46721,6
9347,46702,19,46721,3,46724,7
9340,46703,21,46724,3,46727,7
9341,46709,18,46727,3,46730,6
9348,46709,21,46730,3,46733,7
9349,46717,16,46733,3,46736,6
9350,46720,16,46736,3,46739,6
9344,46721,18,46739,3,46742,6
9344,46724,18,46742,3,46745,6
9351,46724,21,46745,3,46748,7
9352,46725,23,46748,3,46751,8
9353,46734,17,46751,3,46754,6
9354,46737,17,46754,3,46757,6
9355,46746,11,46757,3,46760,4
9356,46752,8,46760,3,46763,3
9357,46757,6,46763,3,46766,2
9358,46762,4,46766,3,46769,2
9357,46766,3,46769,3,46772,1
9359,46775,0,46775,3,46778,0
9360,46778,0,46778,3,46781,0
9360,46781,0,46781,3,46784,0
9361,46784,0,46784,3,46787,0
9361,46787,0,46787,3,46790,0
9362,46790,0,46790,3,46793,0
9363,46791,2,46793,3,46796,1
9363,46796,0,46796,3,46799,0
9364,46799,0,46799,3,46802,0
9365,46805,0,46805,3,46808,0
9366,46808,0,46808,3,46811,0
9367,46813,0,46813,3,46816,0
9368,46817,0,46817,3,46820,0
9369,46824,0,46824,3,46827,0
9370,46827,0,46827,3,46830,0
9371,46835,0,46835,3,46838,0
9372,46837,1,46838,3,46841,1
9371,46838,3,46841,3,46844,1
9373,46841,3,46844,3,46847,1
9374,46845,2,46847,3,46850,1
9373,46847,3,46850,3,46853,1
9373,46850,3,46853,3,46856,1
9375,46850,6,46856,3,46859,2
9376,46857,2,46859,3,46862,1
9377,46862,0,46862,3,46865,0
9378,46870,0,46870,3,46873,0
9379,46877,0,46877,3,46880,0
9379,46880,0,46880,3,46883,0
9380,46881,2,46883,3,46886,1
9379,46883,3,46886,3,46889,1
9381,46885,4,46889,3,46892,2
9382,46888,4,46892,3,46895,2
9383,46893,2,46895,3,46898,1
9384,46897,1,46898,3,46901,1
9385,46902,0,46902,3,46905,0
9386,46906,0,46906,3,46909,0
9386,46909,0,46909,3,46912,0
9387,46911,1,46912,3,46915,1
9387,46915,0,46915,3,46918,0
9388,46916,2,46918,3,46921,1
9389,46918,3,46921,3,46924,1
9390,46920,4,46924,3,46927,2
9391,46924,3,46927,3,46930,1
9392,46928,2,46930,3,46933,1
9393,46931,2,46933,3,46936,1
9394,46937,0,46937,3,46940,0
9394,46940,0,46940,3,46943,0
9395,46941,2,46943,3,46946,1
9396,46943,3,46946,3,46949,1
9397,46949,0,46949,3,46952,0
9398,46953,0,46953,3,46956,0
9398,46956,0,46956,3,46959,0
9398,46959,0,46959,3,46962,0
9399,46964,0,46964,3,46967,0
9400,46972,0,46972,3,46975,0
9401,46973,2,46975,3,46978,1
9402,46974,4,46978,3,46981,2
9400,46975,6,46981,3,46984,2
9403,46979,5,46984,3,46987,2
9401,46981,6,46987,3,46990,2
9404,46982,8,46990,3,46993,3
9401,46984,9,46993,3,46996,3
9405,46989,7,46996,3,46999,3
9402,46990,9,46999,3,47002,3
9406,46995,7,47002,3,47005,3
9403,46996,9,47005,3,47008,3
9407,47000,8,47008,3,47011,3
9408,47003,8,47011,3,47014,3
9406,47008,6,47014,3,47017,2
9409,47010,7,47017,3,47020,3
9406,47011,9,47020,3,47023,3
9410,47011,12,47023,3,47026,4
9406,47014,12,47026,3,47029,4
9411,47014,15,47029,3,47032,5
9412,47014,18,47032,3,47035,6
9413,47017,18,47035,3,47038,6
9407,47020,18,47038,3,47041,6
9414,47020,21,47041,3,47044,7
9415,47023,21,47044,3,47047,7
9409,47029,18,47047,3,47050,6
9416,47031,19,47050,3,47053,7
9410,47035,18,47053,3,47056,6
9417,47036,20,47056,3,47059,7
9418,47037,22,47059,3,47062,8
9410,47038,24,47062,3,47065,8
9419,47043,22,47065,3,47068,8
9411,47044,24,47068,3,47071,8
9412,47050,21,47071,3,47074,7
9420,47050,24,47074,3,47077,8
9421,47055,22,47077,3,47080,8
9422,47058,22,47080,3,47083,8
9423,47064,19,47083,3,47086,7
9424,47069,17,47086,3,47089,6
9425,47073,16,47089,3,47092,6
9419,47074,18,47092,3,47095,6
9426,47075,20,47095,3,47098,7
9427,47080,18,47098,3,47101,6
9428,47085,16,47101,3,47104,6
9429,47087,17,47104,3,47107,6
9430,47090,17,47107,3,47110,6
9431,47092,18,47110,3,47113,6
9425,47095,18,47113,3,47116,6
9432,47095,21,47116,3,47119,7
9433,47098,21,47119,3,47122,7
9426,47101,21,47122,3,47125,7
9426,47104,21,47125,3,47128,7
9434,47106,22,47128,3,47131,8
9426,47107,24,47131,3,47134,8
9426,47110,24,47134,3,47137,8
9435,47110,27,47137,3,47140,9
9436,47112,28,47140,3,47143,10
9426,47113,30,47143,3,47146,10
9426,47116,30,47146,3,47149,10
9437,47116,33,47149,3,47152,11
9438,47120,32,47152,3,47155,11
9439,47123,32,47155,3,47158,11
9440,47127,31,47158,3,47161,11
9429,47128,33,47161,3,47164,11
9441,47135,29,47164,3,47167,10
9442,47139,28,47167,3,47170,10
9433,47143,27,47170,3,47173,9
9443,47144,29,47173,3,47176,10
9434,47149,27,47176,3,47179,9
9444,47151,28,47179,3,47182,10
9434,47152,30,47182,3,47185,10
9435,47158,27,47185,3,47188,9
9445,47159,29,47188,3,47191,10
9436,47164,27,47191,3,47194,9
9446,47166,28,47194,3,47197,10
9447,47173,24,47197,3,47200,8
9448,47176,24,47200,3,47203,8
9449,47180,23,47203,3,47206,8
9450,47185,21,47206,3,47209,7
9451,47187,22,47209,3,47212,8
9443,47188,24,47212,3,47215,8
9452,47192,23,47215,3,47218,8
9453,47198,20,47218,3,47221,7
9454,47205,16,47221,3,47224,6
9449,47209,15,47224,3,47227,5
9449,47212,15,47227,3,47230,5
9455,47216,14,47230,3,47233,5
9450,47218,15,47233,3,47236,5
9456,47220,16,47236,3,47239,6
9450,47221,18,47239,3,47242,6
9450,47224,18,47242,3,47245,6
9450,47227,18,47245,3,47248,6
9457,47229,19,47248,3,47251,7
9458,47236,15,47251,3,47254,5
9459,47236,18,47254,3,47257,6
9453,47239,18,47257,3,47260,6
9460,47240,20,47260,3,47263,7
9461,47242,21,47263,3,47266,7
9462,47245,21,47266,3,47269,7
9463,47258,11,47269,3,47272,4
9464,47261,11,47272,3,47275,4
9465,47263,12,47275,3,47278,4
9461,47266,12,47278,3,47281,4
9466,47270,11,47281,3,47284,4
9462,47272,12,47284,3,47287,4
9467,47275,12,47287,3,47290,4
9468,47281,9,47290,3,47293,3
9469,47284,9,47293,3,47296,3
9466,47287,9,47296,3,47299,3
9470,47292,7,47299,3,47302,3
9471,47293,9,47302,3,47305,3
9468,47296,9,47305,3,47308,3
9468,47299,9,47308,3,47311,3
9472,47299,12,47311,3,47314,4
9473,47304,10,47314,3,47317,4
9470,47308,9,47317,3,47320,3
9474,47309,11,47320,3,47323,4
9475,47314,9,47323,3,47326,3
9476,47323,3,47326,3,47329,1
9475,47326,3,47329,3,47332,1
9477,47335,0,47335,3,47338,0
9478,47341,0,47341,3,47344,0
9479,47348,0,47348,3,47351,0
9480,47352,0,47352,3,47355,0
9481,47354,1,47355,3,47358,1
9480,47355,3,47358,3,47361,1
9482,47359,2,47361,3,47364,1
9483,47363,1,47364,3,47367,1
9482,47364,3,47367,3,47370,1
9483,47370,0,47370,3,47373,0
9484,47371,2,47373,3,47376,1
9485,47375,1,47376,3,47379,1
9484,47376,3,47379,3,47382,1
9485,47382,0,47382,3,47385,0
9486,47383,2,47385,3,47388,1
9487,47389,0,47389,3,47392,0
9487,47392,0,47392,3,47395,0
9488,47394,1,47395,3,47398,1
9487,47395,3,47398,3,47401,1
9489,47402,0,47402,3,47405,0
9489,47405,0,47405,3,47408,0
9490,47409,0,47409,3,47412,0
9490,47412,0,47412,3,47415,0
9491,47415,0,47415,3,47418,0
9492,47421,0,47421,3,47424,0
9492,47424,0,47424,3,47427,0
9493,47426,1,47427,3,47430,1
9494,47429,1,47430,3,47433,1
9495,47438,0,47438,3,47441,0
9495,47441,0,47441,3,47444,0
9496,47447,0,47447,3,47450,0
9496,47450,0,47450,3,47453,0
9497,47452,1,47453,3,47456,1
9498,47458,0,47458,3,47461,0
9499,47461,0,47461,3,47464,0
9500,47471,0,47471,3,47474,0
9501,47477,0,47477,3,47480,0
9501,47480,0,47480,3,47483,0
9502,47482,1,47483,3,47486,1
9501,47483,3,47486,3,47489,1
9501,47486,3,47489,3,47492,1
9501,47489,3,47492,3,47495,1
9503,47490,5,47495,3,47498,2
9501,47492,6,47498,3,47501,2
9504,47494,7,47501,3,47504,3
9505,47496,8,47504,3,47507,3
9506,47499,8,47507,3,47510,3
9507,47504,6,47510,3,47513,2
9505,47507,6,47513,3,47516,2
9508,47507,9,47516,3,47519,3
9509,47512,7,47519,3,47522,3
9510,47515,7,47522,3,47525,3
9509,47522,3,47525,3,47528,1
9511,47523,5,47528,3,47531,2
9509,47525,6,47531,3,47534,2
9512,47530,4,47534,3,47537,2
9513,47533,4,47537,3,47540,2
9514,47538,2,47540,3,47543,1
9513,47540,3,47543,3,47546,1
9515,47544,2,47546,3,47549,1
9516,47548,1,47549,3,47552,1
9516,47552,0,47552,3,47555,0
9517,47552,3,47555,3,47558,1
9516,47555,3,47558,3,47561,1
9518,47558,3,47561,3,47564,1
9519,47561,3,47564,3,47567,1
9520,47563,4,47567,3,47570,2
9521,47567,3,47570,3,47573,1
9522,47574,0,47574,3,47577,0
9523,47578,0,47578,3,47581,0
9524,47584,0,47584,3,47587,0
9525,47592,0,47592,3,47595,0
9526,47594,1,47595,3,47598,1
9525,47595,3,47598,3,47601,1
9527,47600,1,47601,3,47604,1
9526,47601,3,47604,3,47607,1
9526,47604,3,47607,3,47610,1
9528,47606,4,47610,3,47613,2
9527,47610,3,47613,3,47616,1
9529,47614,2,47616,3,47619,1
9530,47614,5,47619,3,47622,2
9531,47618,4,47622,3,47625,2
9529,47619,6,47625,3,47628,2
9532,47626,2,47628,3,47631,1
9533,47632,0,47632,3,47635,0
9534,47638,0,47638,3,47641,0
9535,47644,0,47644,3,47647,0
9536,47653,0,47653,3,47656,0
9537,47658,0,47658,3,47661,0
9537,47661,0,47661,3,47664,0
9538,47663,1,47664,3,47667,1
9539,47670,0,47670,3,47673,0
9539,47673,0,47673,3,47676,0
9540,47676,0,47676,3,47679,0
9541,47680,0,47680,3,47683,0
9541,47683,0,47683,3,47686,0
9542,47686,0,47686,3,47689,0
9543,47689,0,47689,3,47692,0
9544,47694,0,47694,3,47697,0
9544,47697,0,47697,3,47700,0
9545,47698,2,47700,3,47703,1
9546,47699,4,47703,3,47706,2
9544,47700,6,47706,3,47709,2
9547,47703,6,47709,3,47712,2
9548,47708,4,47712,3,47715,2
9549,47716,0,47716,3,47719,0
9550,47721,0,47721,3,47724,0
9551,47722,2,47724,3,47727,1
9552,47724,3,47727,3,47730,1
9553,47732,0,47732,3,47735,0
9554,47737,0,47737,3,47740,0
9555,47742,0,47742,3,47745,0
9556,47747,0,47747,3,47750,0
9557,47751,0,47751,3,47754,0
9558,47760,0,47760,3,47763,0
9558,47763,0,47763,3,47766,0
9559,47766,0,47766,3,47769,0
9560,47773,0,47773,3,47776,0
9560,47776,0,47776,3,47779,0
9561,47779,0,47779,3,47782,0
9562,47786,0,47786,3,47789,0
9563,47789,0,47789,3,47792,0
9563,47792,0,47792,3,47795,0
9564,47798,0,47798,3,47801,0
9565,47809,0,47809,3,47812,0
9566,47812,0,47812,3,47815,0
9566,47815,0,47815,3,47818,0
9567,47818,0,47818,3,47821,0
9567,47821,0,47821,3,47824,0
9568,47822,2,47824,3,47827,1
9569,47824,3,47827,3,47830,1
9570,47826,4,47830,3,47833,2
9569,47830,3,47833,3,47836,1
9571,47833,3,47836,3,47839,1
9570,47836,3,47839,3,47842,1
9572,47837,5,47842,3,47845,2
9570,47839,6,47845,3,47848,2
9570,47842,6,47848,3,47851,2
9573,47847,4,47851,3,47854,2
9572,47851,3,47854,3,47857,1
9574,47851,6,47857,3,47860,2
9572,47854,6,47860,3,47863,2
9575,47859,4,47863,3,47866,2
9573,47860,6,47866,3,47869,2
9576,47862,7,47869,3,47872,3
9577,47864,8,47872,3,47875,3
9578,47866,9,47875,3,47878,3
9575,47869,9,47878,3,47881,3
9579,47873,8,47881,3,47884,3
9580,47877,7,47884,3,47887,3
9581,47880,7,47887,3,47890,3
9578,47881,9,47890,3,47893,3
9582,47884,9,47893,3,47896,3
9583,47890,6,47896,3,47899,2
9584,47893,6,47899,3,47902,2
9585,47896,6,47902,3,47905,2
9586,47902,3,47905,3,47908,1
9587,47908,0,47908,3,47911,0
9587,47911,0,47911,3,47914,0
9588,47913,1,47914,3,47917,1
9589,47918,0,47918,3,47921,0
9590,47924,0,47924,3,47927,0
9591,47931,0,47931,3,47934,0
9592,47937,0,47937,3,47940,0
9593,47941,0,47941,3,47944,0
9593,47944,0,47944,3,47947,0
9594,47946,1,47947,3,47950,1
9593,47947,3,47950,3,47953,1
9595,47949,4,47953,3,47956,2
9596,47952,4,47956,3,47959,2
9597,47959,0,47959,3,47962,0
9598,47965,0,47965,3,47968,0
9599,47975,0,47975,3,47978,0
9600,47981,0,47981,3,47984,0
9600,47984,0,47984,3,47987,0
9600,47987,0,47987,3,47990,0
9601,47988,2,47990,3,47993,1
9602,47999,0,47999,3,48002,0
9603,48009,0,48009,3,48012,0
9604,48013,0,48013,3,48016,0
9604,48016,0,48016,3,48019,0
9605,48023,0,48023,3,48026,0
9605,48026,0,48026,3,48029,0
9606,48028,1,48029,3,48032,1
9607,48030,2,48032,3,48035,1
9606,48032,3,48035,3,48038,1
9606,48035,3,48038,3,48041,1
9606,48038,3,48041,3,48044,1
9606,48041,3,48044,3,48047,1
9608,48042,5,48047,3,48050,2
9606,48044,6,48050,3,48053,2
9609,48049,4,48053,3,48056,2
9607,48050,6,48056,3,48059,2
9610,48055,4,48059,3,48062,2
9609,48059,3,48062,3,48065,1
9611,48060,5,48065,3,48068,2
9612,48065,3,48068,3,48071,1
9613,48070,1,48071,3,48074,1
9612,48071,3,48074,3,48077,1
9614,48071,6,48077,3,48080,2
9615,48075,5,48080,3,48083,2
9616,48077,6,48083,3,48086,2
9617,48085,1,48086,3,48089,1
9618,48087,2,48089,3,48092,1
9618,48092,0,48092,3,48095,0
9619,48093,2,48095,3,48098,1
9620,48096,2,48098,3,48101,1
9621,48102,0,48102,3,48105,0
9622,48110,0,48110,3,48113,0
9623,48116,0,48116,3,48119,0
9623,48119,0,48119,3,48122,0
9623,48122,0,48122,3,48125,0
9624,48125,0,48125,3,48128,0
9625,48128,0,48128,3,48131,0
9625,48131,0,48131,3,48134,0
9626,48139,0,48139,3,48142,0
9626,48142,0,48142,3,48145,0
9627,48145,0,48145,3,48148,0
9628,48149,0,48149,3,48152,0
9628,48152,0,48152,3,48155,0
9628,48155,0,48155,3,48158,0
9629,48156,2,48158,3,48161,1
9628,48158,3,48161,3,48164,1
9630,48159,5,48164,3,48167,2
9628,48161,6,48167,3,48170,2
9631,48162,8,48170,3,48173,3
9628,48164,9,48173,3,48176,3
9632,48170,6,48176,3,48179,2
9633,48175,4,48179,3,48182,2
9632,48179,3,48182,3,48185,1
9634,48181,4,48185,3,48188,2
9632,48182,6,48188,3,48191,2
9635,48189,2,48191,3,48194,1
9636,48192,2,48194,3,48197,1
9637,48201,0,48201,3,48204,0
9638,48204,0,48204,3,48207,0
9639,48210,0,48210,3,48213,0
9640,48214,0,48214,3,48217,0
9640,48217,0,48217,3,48220,0
9641,48219,1,48220,3,48223,1
9642,48222,1,48223,3,48226,1
9643,48229,0,48229,3,48232,0
9643,48232,0,48232,3,48235,0
9644,48233,2,48235,3,48238,1
9645,48238,0,48238,3,48241,0
9646,48242,0,48242,3,48245,0
9646,48245,0,48245,3,48248,0
9647,48247,1,48248,3,48251,1
9648,48249,2,48251,3,48254,1
9649,48252,2,48254,3,48257,1
9650,48258,0,48258,3,48261,0
9651,48264,0,48264,3,48267,0
9652,48270,0,48270,3,48273,0
9653,48272,1,48273,3,48276,1
9653,48276,0,48276,3,48279,0
9654,48279,0,48279,3,48282,0
9654,48282,0,48282,3,48285,0
9655,48282,3,48285,3,48288,1
9656,48288,0,48288,3,48291,0
9657,48291,0,48291,3,48294,0
9657,48294,0,48294,3,48297,0
9658,48296,1,48297,3,48300,1
9659,48301,0,48301,3,48304,0
9660,48309,0,48309,3,48312,0
9661,48319,0,48319,3,48322,0
9661,48322,0,48322,3,48325,0
9662,48325,0,48325,3,48328,0
9663,48332,0,48332,3,48335,0
9664,48335,0,48335,3,48338,0
9665,48344,0,48344,3,48347,0
9665,48347,0,48347,3,48350,0
9666,48353,0,48353,3,48356,0
9667,48359,0,48359,3,48362,0
9667,48362,0,48362,3,48365,0
9667,48365,0,48365,3,48368,0
9668,48365,3,48368,3,48371,1
9669,48368,3,48371,3,48374,1
9670,48375,0,48375,3,48378,0
9671,48381,0,48381,3,48384,0
9671,48384,0,48384,3,48387,0
9672,48386,1,48387,3,48390,1
9672,48390,0,48390,3,48393,0
9673,48390,3,48393,3,48396,1
9672,48393,3,48396,3,48399,1
9674,48394,5,48399,3,48402,2
9672,48396,6,48402,3,48405,2
9672,48399,6,48405,3,48408,2
9672,48402,6,48408,3,48411,2
9675,48402,9,48411,3,48414,3
9672,48405,9,48414,3,48417,3
9672,48408,9,48417,3,48420,3
9672,48411,9,48420,3,48423,3
9676,48411,12,48423,3,48426,4
9673,48417,9,48426,3,48429,3
9677,48418,11,48429,3,48432,4
9678,48421,11,48432,3,48435,4
9679,48427,8,48435,3,48438,3
9676,48429,9,48438,3,48441,3
9680,48430,11,48441,3,48444,4
9681,48437,7,48444,3,48447,3
9682,48445,2,48447,3,48450,1
9681,48447,3,48450,3,48453,1
9683,48451,2,48453,3,48456,1
9684,48457,0,48457,3,48460,0
9685,48466,0,48466,3,48469,0
9686,48469,0,48469,3,48472,0
9687,48476,0,48476,3,48479,0
9687,48479,0,48479,3,48482,0
9688,48483,0,48483,3,48486,0
9689,48491,0,48491,3,48494,0
9690,48495,0,48495,3,48498,0
9690,48498,0,48498,3,48501,0
9691,48498,3,48501,3,48504,1
9692,48501,3,48504,3,48507,1
9693,48503,4,48507,3,48510,2
9694,48508,2,48510,3,48513,1
9693,48510,3,48513,3,48516,1
9695,48515,1,48516,3,48519,1
9696,48524,0,48524,3,48527,0
9697,48528,0,48528,3,48531,0
9698,48530,1,48531,3,48534,1
9699,48534,0,48534,3,48537,0
9699,48537,0,48537,3,48540,0
9699,48540,0,48540,3,48543,0
9700,48542,1,48543,3,48546,1
9701,48549,0,48549,3,48552,0
9702,48552,0,48552,3,48555,0
9702,48555,0,48555,3,48558,0
9703,48556,2,48558,3,48561,1
9702,48558,3,48561,3,48564,1
9704,48562,2,48564,3,48567,1
9705,48565,2,48567,3,48570,1
9704,48567,3,48570,3,48573,1
9706,48569,4,48573,3,48576,2
9704,48570,6,48576,3,48579,2
9707,48573,6,48579,3,48582,2
9708,48577,5,48582,3,48585,2
9706,48579,6,48585,3,48588,2
9709,48586,2,48588,3,48591,1
9710,48594,0,48594,3,48597,0
9711,48597,0,48597,3,48600,0
9712,48603,0,48603,3,48606,0
9712,48606,0,48606,3,48609,0
9713,48607,2,48609,3,48612,1
9714,48610,2,48612,3,48615,1
9715,48611,4,48615,3,48618,2
9714,48615,3,48618,3,48621,1
9714,48618,3,48621,3,48624,1
9716,48620,4,48624,3,48627,2
9714,48621,6,48627,3,48630,2
9717,48625,5,48630,3,48633,2
9718,48632,1,48633,3,48636,1
9717,48633,3,48636,3,48639,1
9719,48637,2,48639,3,48642,1
9720,48643,0,48643,3,48646,0
9721,48650,0,48650,3,48653,0
9721,48653,0,48653,3,48656,0
9722,48655,1,48656,3,48659,1
9723,48657,2,48659,3,48662,1
9724,48661,1,48662,3,48665,1
9725,48669,0,48669,3,48672,0
9726,48678,0,48678,3,48681,0
9727,48684,0,48684,3,48687,0
9728,48689,0,48689,3,48692,0
9729,48695,0,48695,3,48698,0
9730,48700,0,48700,3,48703,0
9731,48705,0,48705,3,48708,0
9731,48708,0,48708,3,48711,0
9732,48708,3,48711,3,48714,1
9733,48711,3,48714,3,48717,1
9732,48714,3,48717,3,48720,1
9732,48717,3,48720,3,48723,1
9734,48718,5,48723,3,48726,2
9732,48720,6,48726,3,48729,2
9735,48724,5,48729,3,48732,2
9733,48726,6,48732,3,48735,2
9736,48729,6,48735,3,48738,2
9737,48734,4,48738,3,48741,2
9736,48738,3,48741,3,48744,1
9738,48739,5,48744,3,48747,2
9739,48740,7,48747,3,48750,3
9736,48741,9,48750,3,48753,3
9740,48744,9,48753,3,48756,3
9741,48749,7,48756,3,48759,3
9739,48753,6,48759,3,48762,2
9742,48754,8,48762,3,48765,3
9743,48761,4,48765,3,48768,2
9741,48762,6,48768,3,48771,2
9744,48763,8,48771,3,48774,3
9741,48765,9,48774,3,48777,3
9741,48768,9,48777,3,48780,3
9745,48769,11,48780,3,48783,4
9746,48774,9,48783,3,48786,3
9747,48779,7,48786,3,48789,3
9748,48784,5,48789,3,48792,2
9746,48786,6,48792,3,48795,2
9749,48787,8,48795,3,48798,3
9750,48792,6,48798,3,48801,2
9748,48795,6,48801,3,48804,2
9751,48798,6,48804,3,48807,2
9752,48805,2,48807,3,48810,1
9751,48807,3,48810,3,48813,1
9753,48808,5,48813,3,48816,2
9754,48817,0,48817,3,48820,0
9754,48820,0,48820,3,48823,0
9755,48824,0,48824,3,48827,0
9756,48826,1,48827,3,48830,1
9757,48832,0,48832,3,48835,0
9757,48835,0,48835,3,48838,0
9758,48837,1,48838,3,48841,1
9758,48841,0,48841,3,48844,0
9759,48841,3,48844,3,48847,1
9760,48846,1,48847,3,48850,1
9760,48850,0,48850,3,48853,0
9761,48851,2,48853,3,48856,1
9762,48855,1,48856,3,48859,1
9763,48860,0,48860,3,48863,0
9764,48863,0,48863,3,48866,0
9764,48866,0,48866,3,48869,0
9765,48867,2,48869,3,48872,1
9766,48875,0,48875,3,48878,0
9766,48878,0,48878,3,48881,0
9767,48879,2,48881,3,48884,1
9768,48882,2,48884,3,48887,1
9769,48886,1,48887,3,48890,1
9770,48887,3,48890,3,48893,1
9771,48895,0,48895,3,48898,0
9772,48899,0,48899,3,48902,0
9773,48903,0,48903,3,48906,0
9774,48909,0,48909,3,48912,0
9775,48915,0,48915,3,48918,0
9776,48918,0,48918,3,48921,0
9776,48921,0,48921,3,48924,0
9777,48923,1,48924,3,48927,1
9778,48929,0,48929,3,48932,0
9778,48932,0,48932,3,48935,0
9779,48932,3,48935,3,48938,1
9780,48934,4,48938,3,48941,2
9778,48935,6,48941,3,48944,2
9781,48936,8,48944,3,48947,3
9778,48938,9,48947,3,48950,3
9782,48941,9,48950,3,48953,3
9783,48945,8,48953,3,48956,3
9784,48952,4,48956,3,48959,2
9783,48956,3,48959,3,48962,1
9785,48958,4,48962,3,48965,2
9786,48961,4,48965,3,48968,2
9784,48962,6,48968,3,48971,2
9785,48968,3,48971,3,48974,1
9787,48969,5,48974,3,48977,2
9785,48971,6,48977,3,48980,2
9788,48974,6,48980,3,48983,2
9789,48979,4,48983,3,48986,2
9787,48980,6,48986,3,48989,2
9790,48982,7,48989,3,48992,3
9787,48983,9,48992,3,48995,3
9791,48987,8,48995,3,48998,3
9788,48989,9,48998,3,49001,3
9792,48992,9,49001,3,49004,3
9790,48998,6,49004,3,49007,2
9793,48998,9,49007,3,49010,3
9790,49001,9,49010,3,49013,3
9794,49002,11,49013,3,49016,4
9792,49010,6,49016,3,49019,2
9795,49010,9,49019,3,49022,3
9796,49020,2,49022,3,49025,1
9795,49022,3,49025,3,49028,1
9797,49024,4,49028,3,49031,2
9798,49029,2,49031,3,49034,1
9799,49033,1,49034,3,49037,1
9800,49035,2,49037,3,49040,1
9801,49037,3,49040,3,49043,1
9802,49040,3,49043,3,49046,1
9803,49044,2,49046,3,49049,1
9802,49046,3,49049,3,49052,1
9804,49049,3,49052,3,49055,1
9805,49053,2,49055,3,49058,1
9806,49058,0,49058,3,49061,0
9807,49063,0,49063,3,49066,0
9808,49064,2,49066,3,49069,1
9809,49068,1,49069,3,49072,1
9810,49075,0,49075,3,49078,0
9810,49078,0,49078,3,49081,0
9811,49078,3,49081,3,49084,1
9810,49081,3,49084,3,49087,1
9812,49081,6,49087,3,49090,2
9813,49085,5,49090,3,49093,2
9814,49087,6,49093,3,49096,2
9812,49090,6,49096,3,49099,2
9812,49093,6,49099,3,49102,2
9815,49093,9,49102,3,49105,3
9816,49096,9,49105,3,49108,3
9817,49099,9,49108,3,49111,3
9814,49102,9,49111,3,49114,3
9818,49102,12,49114,3,49117,4
9819,49107,10,49117,3,49120,4
9817,49114,6,49120,3,49123,2
9820,49114,9,49123,3,49126,3
9821,49119,7,49126,3,49129,3
9819,49123,6,49129,3,49132,2
9822,49125,7,49132,3,49135,3
9819,49126,9,49135,3,49138,3
9823,49133,5,49138,3,49141,2
9821,49135,6,49141,3,49144,2
9824,49135,9,49144,3,49147,3
9823,49144,3,49147,3,49150,1
9825,49145,5,49150,3,49153,2
9826,49152,1,49153,3,49156,1
9825,49153,3,49156,3,49159,1
9827,49159,0,49159,3,49162,0
9827,49162,0,49162,3,49165,0
9828,49162,3,49165,3,49168,1
9829,49166,2,49168,3,49171,1
9829,49171,0,49171,3,49174,0
9829,49174,0,49174,3,49177,0
9830,49174,3,49177,3,49180,1
9829,49177,3,49180,3,49183,1
9831,49182,1,49183,3,49186,1
9832,49185,1,49186,3,49189,1
9833,49192,0,49192,3,49195,0
9834,49197,0,49197,3,49200,0
9835,49200,0,49200,3,49203,0
9836,49204,0,49204,3,49207,0
9836,49207,0,49207,3,49210,0
9837,49210,0,49210,3,49213,0
9838,49213,0,49213,3,49216,0
9839,49215,1,49216,3,49219,1
9838,49216,3,49219,3,49222,1
9840,49225,0,49225,3,49228,0
9840,49228,0,49228,3,49231,0
9841,49230,1,49231,3,49234,1
9842,49237,0,49237,3,49240,0
9842,49240,0,49240,3,49243,0
9843,49241,2,49243,3,49246,1
9844,49249,0,49249,3,49252,0
9844,49252,0,49252,3,49255,0
9845,49253,2,49255,3,49258,1
9845,49258,0,49258,3,49261,0
9845,49261,0,49261,3,49264,0
9846,49262,2,49264,3,49267,1
9847,49267,0,49267,3,49270,0
9848,49274,0,49274,3,49277,0
9849,49281,0,49281,3,49284,0
9850,49286,0,49286,3,49289,0
9851,49291,0,49291,3,49294,0
9852,49297,0,49297,3,49300,0
9852,49300,0,49300,3,49303,0
9853,49300,3,49303,3,49306,1
9854,49305,1,49306,3,49309,1
9855,49310,0,49310,3,49313,0
9855,49313,0,49313,3,49316,0
9855,49316,0,49316,3,49319,0
9856,49318,1,49319,3,49322,1
9857,49323,0,49323,3,49326,0
9857,49326,0,49326,3,49329,0
9858,49330,0,49330,3,49333,0
9858,49333,0,49333,3,49336,0
9859,49336,0,49336,3,49339,0
9860,49345,0,49345,3,49348,0
9861,49347,1,49348,3,49351,1
9862,49351,0,49351,3,49354,0
9863,49352,2,49354,3,49357,1
9864,49354,3,49357,3,49360,1
9865,49360,0,49360,3,49363,0
9866,49366,0,49366,3,49369,0
9867,49370,0,49370,3,49373,0
9868,49372,1,49373,3,49376,1
9869,49372,4,49376,3,49379,2
9870,49374,5,49379,3,49382,2
9869,49379,3,49382,3,49385,1
9871,49379,6,49385,3,49388,2
9872,49383,5,49388,3,49391,2
9873,49388,3,49391,3,49394,1
9872,49391,3,49394,3,49397,1
9874,49394,3,49397,3,49400,1
9875,49401,0,49401,3,49404,0
9876,49406,0,49406,3,49409,0
9876,49409,0,49409,3,49412,0
9877,49409,3,49412,3,49415,1
9876,49412,3,49415,3,49418,1
9878,49415,3,49418,3,49421,1
9879,49419,2,49421,3,49424,1
9880,49423,1,49424,3,49427,1
9881,49424,3,49427,3,49430,1
9880,49427,3,49430,3,49433,1
9882,49432,1,49433,3,49436,1
9883,49435,1,49436,3,49439,1
9882,49436,3,49439,3,49442,1
9884,49437,5,49442,3,49445,2
9885,49439,6,49445,3,49448,2
9883,49442,6,49448,3,49451,2
9886,49445,6,49451,3,49454,2
9887,49450,4,49454,3,49457,2
9888,49455,2,49457,3,49460,1
9887,49457,3,49460,3,49463,1
9889,49462,1,49463,3,49466,1
9890,49463,3,49466,3,49469,1
9889,49466,3,49469,3,49472,1
9891,49467,5,49472,3,49475,2
9892,49470,5,49475,3,49478,2
9890,49472,6,49478,3,49481,2
9890,49475,6,49481,3,49484,2
9893,49476,8,49484,3,49487,3
9894,49483,4,49487,3,49490,2
9895,49486,4,49490,3,49493,2
9894,49490,3,49493,3,49496,1
9896,49496,0,49496,3,49499,0
9897,49502,0,49502,3,49505,0
9898,49506,0,49506,3,49509,0
9899,49509,0,49509,3,49512,0
9900,49510,2,49512,3,49515,1
9901,49512,3,49515,3,49518,1
9902,49513,5,49518,3,49521,2
9901,49518,3,49521,3,49524,1
9903,49518,6,49524,3,49527,2
9901,49521,6,49527,3,49530,2
9904,49527,3,49530,3,49533,1
9905,49533,0,49533,3,49536,0
9906,49535,1,49536,3,49539,1
9907,49540,0,49540,3,49543,0
9908,49544,0,49544,3,49547,0
9909,49547,0,49547,3,49550,0
9910,49549,1,49550,3,49553,1
9911,49554,0,49554,3,49557,0
9912,49557,0,49557,3,49560,0
9912,49560,0,49560,3,49563,0
9913,49564,0,49564,3,49567,0
9914,49565,2,49567,3,49570,1
9915,49570,0,49570,3,49573,0
9916,49574,0,49574,3,49577,0
9917,49580,0,49580,3,49583,0
9918,49584,0,49584,3,49587,0
9919,49586,1,49587,3,49590,1
9918,49587,3,49590,3,49593,1
9920,49590,3,49593,3,49596,1
9919,49593,3,49596,3,49599,1
9921,49594,5,49599,3,49602,2
9922,49599,3,49602,3,49605,1
9923,49606,0,49606,3,49609,0
9924,49610,0,49610,3,49613,0
9925,49614,0,49614,3,49617,0
9926,49620,0,49620,3,49623,0
9926,49623,0,49623,3,49626,0
9927,49624,2,49626,3,49629,1
9928,49632,0,49632,3,49635,0
9929,49643,0,49643,3,49646,0
9930,49646,0,49646,3,49649,0
9931,49652,0,49652,3,49655,0
9931,49655,0,49655,3,49658,0
9932,49656,2,49658,3,49661,1
9931,49658,3,49661,3,49664,1
9933,49663,1,49664,3,49667,1
9934,49670,0,49670,3,49673,0
9934,49673,0,49673,3,49676,0
9935,49677,0,49677,3,49680,0
9935,49680,0,49680,3,49683,0
9936,49681,2,49683,3,49686,1
9937,49688,0,49688,3,49691,0
9937,49691,0,49691,3,49694,0
9938,49695,0,49695,3,49698,0
9939,49698,0,49698,3,49701,0
9940,49700,1,49701,3,49704,1
9941,49705,0,49705,3,49708,0
9941,49708,0,49708,3,49711,0
9942,49708,3,49711,3,49714,1
9942,49714,0,49714,3,49717,0
9943,49717,0,49717,3,49720,0
9944,49719,1,49720,3,49723,1
9943,49720,3,49723,3,49726,1
9945,49722,4,49726,3,49729,2
9946,49728,1,49729,3,49732,1
9947,49731,1,49732,3,49735,1
9948,49739,0,49739,3,49742,0
9949,49748,0,49748,3,49751,0
9950,49751,0,49751,3,49754,0
9950,49754,0,49754,3,49757,0
9951,49755,2,49757,3,49760,1
9950,49757,3,49760,3,49763,1
9952,49760,3,49763,3,49766,1
9953,49764,2,49766,3,49769,1
9954,49770,0,49770,3,49773,0
9955,49774,0,49774,3,49777,0
9956,49778,0,49778,3,49781,0
9957,49782,0,49782,3,49785,0
9958,49784,1,49785,3,49788,1
9958,49788,0,49788,3,49791,0
9959,49789,2,49791,3,49794,1
9958,49791,3,49794,3,49797,1
9958,49794,3,49797,3,49800,1
9960,49796,4,49800,3,49803,2
9961,49799,4,49803,3,49806,2
9959,49800,6,49806,3,49809,2
9962,49809,0,49809,3,49812,0
9963,49813,0,49813,3,49816,0
9964,49818,0,49818,3,49821,0
9965,49821,0,49821,3,49824,0
9966,49824,0,49824,3,49827,0
9967,49829,0,49829,3,49832,0
9967,49832,0,49832,3,49835,0
9968,49836,0,49836,3,49839,0
9969,49842,0,49842,3,49845,0
9970,49849,0,49849,3,49852,0
9971,49855,0,49855,3,49858,0
9972,49862,0,49862,3,49865,0
9973,49868,0,49868,3,49871,0
9974,49872,0,49872,3,49875,0
9974,49875,0,49875,3,49878,0
9975,49877,1,49878,3,49881,1
9976,49880,1,49881,3,49884,1
9977,49891,0,49891,3,49894,0
9978,49897,0,49897,3,49900,0
9979,49901,0,49901,3,49904,0
9980,49910,0,49910,3,49913,0
9981,49915,0,49915,3,49918,0
9982,49924,0,49924,3,49927,0
9983,49927,0,49927,3,49930,0
9983,49930,0,49930,3,49933,0
9984,49933,0,49933,3,49936,0
9985,49938,0,49938,3,49941,0
9985,49941,0,49941,3,49944,0
9986,49943,1,49944,3,49947,1
9985,49944,3,49947,3,49950,1
9985,49947,3,49950,3,49953,1
9987,49949,4,49953,3,49956,2
9985,49950,6,49956,3,49959,2
9988,49956,3,49959,3,49962,1
9989,49959,3,49962,3,49965,1
9990,49961,4,49965,3,49968,2
9991,49964,4,49968,3,49971,2
9989,49965,6,49971,3,49974,2
9992,49972,2,49974,3,49977,1
9993,49975,2,49977,3,49980,1
9992,49977,3,49980,3,49983,1
9994,49978,5,49983,3,49986,2
9995,49982,4,49986,3,49989,2
9993,49983,6,49989,3,49992,2
9996,49983,9,49992,3,49995,3
9993,49986,9,49995,3,49998,3
9994,49992,6,49998,3,50001,2
9997,49992,9,50001,3,50004,3
9998,49999,5,50004,3,50007,2
9999,50006,1,50007,3,50010,1
